CODECHURN,LOCADDED,LOCDELETED,REVISIONS,AGE,BUGFIXES,REFACTORINGS,ERROR_DENSITY,LOC
56,39,17,3,48,2,0,0.0028735632183908,696
20,15,5,2,114,2,0,0,527
3,3,0,1,52,0,0,0,219
84,60,24,2,112,1,0,0,479
43,35,8,5,76,3,0,0.00489396411092985,613
14,9,5,2,96,1,0,0.00436681222707424,229
18,12,6,2,96,1,0,0.00384615384615385,260
64,58,6,5,53,5,0,0.00138121546961326,724
4,4,0,1,96,1,0,0.0112359550561798,89
89,64,25,3,60,2,0,0.00557620817843866,538
8,8,0,1,97,0,0,0.0149253731343284,67
4,4,0,1,101,0,0,0.000729394602479942,1371
25,15,10,3,60,3,0,0.00325732899022801,614
6,5,1,2,60,2,0,0,102
1,1,0,1,112,1,0,0,95
4,2,2,1,116,1,0,0,886
2,1,1,1,116,1,0,0,112
2,2,0,1,94,1,0,0.00350877192982456,285
103,13,90,4,94,4,0,0.00338983050847458,590
11,0,11,1,94,1,0,0,29
4,3,1,1,41,1,0,0.00384615384615385,260
191,142,49,3,41,2,0,0.00267022696929239,749
0,0,0,1,41,1,0,0,0
0,0,0,1,41,1,0,0,0
58,43,15,4,47,3,0,0,551
870,579,291,23,21,15,0,0.00125786163522013,2385
2,1,1,1,47,1,0,0,32
78,49,29,1,84,0,0,0,304
3,2,1,1,84,0,0,0,52
67,39,28,2,89,1,0,0,216
1,1,0,1,94,1,0,0,25
1,1,0,1,97,1,0,0,138
9,2,7,1,41,1,0,0,672
313,171,142,3,89,3,0,0,227
285,237,48,13,90,6,0,0.000353107344632768,2832
110,91,19,8,83,5,0,0,1515
208,179,29,4,111,2,0,0.00100502512562814,995
44,25,19,2,111,1,0,0,416
2,2,0,2,111,1,0,0,126
9,6,3,2,177,2,0,0,323
5,3,2,1,112,1,0,0,85
26,26,0,2,112,0,0,0,246
62,46,16,6,18,4,0,0.0008,1250
33,20,13,6,28,5,0,0.00140845070422535,710
2,1,1,1,93,0,0,0,101
688,502,186,24,18,15,0,0.0012701100762066,2362
21,17,4,4,112,3,0,0.00609756097560976,164
23,12,11,1,93,1,1,0,1157
20,9,11,1,93,1,1,0,513
2,2,0,1,93,1,1,0,152
58,27,31,1,93,1,1,0,172
6,6,0,1,93,1,1,0,76
7,7,0,1,93,1,1,0,105
26,19,7,1,93,1,1,0,270
8,4,4,1,93,1,1,0,445
74,69,5,1,93,1,1,0,1708
8,7,1,1,93,1,1,0,435
0,0,0,1,93,1,1,0,75
9,5,4,1,93,1,1,0,508
10,10,0,1,93,1,1,0,151
6,6,0,1,93,1,1,0,126
10,10,0,1,93,1,1,0,269
3,2,1,1,93,1,1,0,281
268,240,28,1,93,1,1,0,684
22,13,9,1,93,1,1,0,242
2,2,0,1,93,1,1,0,1057
0,0,0,1,93,1,1,0,52
0,0,0,1,93,1,1,0,66
1,0,1,1,93,1,1,0,133
6,3,3,1,93,1,1,0,371
17,8,9,1,93,1,1,0,232
68,39,29,1,93,1,1,0,220
26,24,2,1,93,1,1,0,306
7,6,1,1,93,1,1,0,211
8,8,0,1,93,1,1,0,176
165,105,60,1,93,1,1,0,454
49,25,24,1,93,1,1,0,293
216,131,85,1,93,1,1,0,757
16,10,6,1,93,1,1,0,906
14,14,0,1,93,1,1,0,132
21,8,13,1,93,1,1,0,170
12,12,0,1,93,1,1,0,490
21,15,6,1,93,1,1,0,437
7,3,4,1,93,1,1,0,38
20,20,0,1,93,1,1,0,126
39,22,17,1,93,1,1,0,296
15,8,7,1,93,1,1,0,457
24,6,18,1,93,1,1,0,368
2,1,1,1,93,1,1,0,707
50,50,0,1,93,1,1,0,106
3,2,1,1,93,1,1,0,205
130,51,79,1,93,1,1,0,333
10,8,2,1,93,1,1,0,412
6,3,3,1,93,1,1,0,111
8,8,0,1,93,1,1,0,366
6,3,3,1,93,1,1,0,33
0,0,0,1,93,1,1,0,72
4,2,2,1,93,1,1,0,83
420,255,165,1,93,1,1,0,840
18,11,7,1,93,1,1,0,348
77,42,35,1,93,1,1,0,1069
2,1,1,1,93,1,1,0,64
74,21,53,1,93,1,1,0,175
71,31,40,1,93,1,1,0,176
4,4,0,1,93,1,1,0,88
22,11,11,1,93,1,1,0,259
2,1,1,1,93,1,1,0,109
12,9,3,1,93,1,1,0,79
25,19,6,1,93,1,1,0,71
5,3,2,1,93,1,1,0,167
0,0,0,1,93,1,1,0,51
0,0,0,1,93,1,1,0,51
2,1,1,1,93,1,1,0,122
87,56,31,1,93,1,1,0,1075
16,10,6,1,93,1,1,0,158
4,2,2,1,93,1,1,0,80
21,19,2,1,93,1,1,0,175
2,1,1,1,93,1,1,0,132
4,2,2,1,93,1,1,0,134
0,0,0,1,93,1,1,0,630
0,0,0,1,93,1,1,0,342
0,0,0,1,93,1,1,0,26
91,68,23,1,93,1,1,0,694
70,48,22,1,93,1,1,0,209
125,60,65,1,93,1,1,0,603
0,0,0,1,93,1,1,0,78
24,3,21,1,93,1,1,0,115
2,1,1,1,93,1,1,0,75
0,0,0,1,93,1,1,0,0
0,0,0,1,93,1,1,0,63
4,3,1,1,93,1,1,0,42
5,5,0,1,93,1,1,0,48
6,6,0,1,93,1,1,0,269
10,4,6,1,93,1,1,0,546
8,5,3,1,93,1,1,0,533
32,24,8,1,93,1,1,0,264
3,2,1,1,93,1,1,0,136
39,33,6,1,93,1,1,0,104
7,6,1,1,93,1,1,0,88
0,0,0,1,93,1,1,0,80
456,259,197,1,93,1,1,0,460
29,27,2,1,93,1,1,0,64
15,11,4,1,93,1,1,0,300
0,0,0,1,93,1,1,0,0
0,0,0,1,93,1,1,0,0
169,97,72,1,93,1,1,0,341
0,0,0,1,93,1,1,0,164
114,56,58,1,93,1,1,0,190
35,16,19,1,93,1,1,0,73
0,0,0,1,93,1,1,0,775
26,19,7,1,93,1,1,0,343
32,7,25,1,93,1,1,0,96
3,2,1,1,93,1,1,0,57
151,59,92,1,93,1,1,0,574
85,56,29,1,93,1,1,0,456
6,3,3,1,93,1,1,0,107
2,1,1,1,93,1,1,0,313
33,25,8,1,93,1,1,0,467
7,4,3,1,93,1,1,0,332
6,3,3,1,93,1,1,0,167
9,7,2,1,93,1,1,0,202
227,155,72,1,93,1,1,0,556
66,31,35,1,93,1,1,0,468
2,1,1,1,93,1,1,0,50
9,6,3,1,93,1,1,0,59
108,84,24,1,93,1,1,0,516
7,6,1,1,93,1,1,0,227
8,6,2,1,93,1,1,0,125
47,17,30,1,93,1,1,0,93
6,3,3,1,93,1,1,0,176
176,85,91,1,93,1,1,0,353
22,12,10,1,93,1,1,0,97
50,42,8,1,93,1,1,0,542
77,60,17,1,93,1,1,0,406
12,6,6,1,93,1,1,0,115
7,0,7,1,93,1,1,0,171
86,44,42,1,93,1,1,0,210
0,0,0,1,93,1,1,0,94
6,4,2,1,93,1,1,0,43
90,90,0,1,93,1,1,0,244
11,10,1,1,93,1,1,0,168
44,44,0,1,93,1,1,0,313
60,38,22,1,93,1,1,0,681
17,15,2,1,93,1,1,0,111
179,130,49,1,93,1,1,0.000962463907603465,1039
42,16,26,1,93,1,1,0,314
950,65,885,1,93,1,1,0,1772
122,93,29,1,93,1,1,0,833
73,33,40,1,93,1,1,0,200
141,65,76,1,93,1,1,0,667
16,10,6,1,93,1,1,0,54
0,0,0,1,93,1,1,0,40
4,4,0,1,93,1,1,0,39
95,50,45,1,93,1,1,0,330
20,7,13,1,93,1,1,0,29
0,0,0,1,93,1,1,0,0
0,0,0,1,93,1,1,0,0
0,0,0,1,93,1,1,0,21
0,0,0,1,93,1,1,0,0
40,24,16,1,93,1,1,0,100
54,6,48,1,93,1,1,0,920
66,1,65,1,93,1,1,0,512
4,2,2,1,93,1,1,0,520
9,1,8,1,93,1,1,0,185
7,5,2,1,93,1,1,0,437
53,36,17,1,93,1,1,0,295
48,46,2,1,93,1,1,0,213
10,9,1,1,93,1,1,0,913
36,33,3,1,93,1,1,0,391
152,97,55,1,93,1,1,0,3162
86,55,31,1,93,1,1,0,325
37,35,2,1,93,1,1,0,88
18,14,4,1,93,1,1,0,162
1,0,1,1,93,1,1,0,54
1,0,1,1,93,1,1,0,299
0,0,0,1,93,1,1,0,29
0,0,0,1,93,1,1,0,46
74,37,37,1,93,1,1,0,440
0,0,0,1,93,1,1,0,135
477,300,177,1,93,1,1,0,805
9,9,0,1,93,1,1,0,80
159,144,15,1,93,1,1,0,286
3,2,1,1,93,1,1,0,51
12,11,1,1,93,1,1,0,60
0,0,0,1,93,1,1,0,156
0,0,0,1,93,1,1,0,54
66,56,10,1,93,1,1,0,404
43,14,29,1,93,1,1,0,93
9,9,0,1,93,1,1,0,142
11,4,7,1,93,1,1,0,48
0,0,0,1,93,1,1,0,56
0,0,0,1,93,1,1,0,44
0,0,0,1,93,1,1,0,67
0,0,0,1,93,1,1,0,169
6,1,5,1,93,1,1,0,68
0,0,0,1,93,1,1,0,0
11,9,2,1,93,1,1,0,178
59,52,7,1,93,1,1,0,133
0,0,0,1,93,1,1,0,76
8,6,2,1,93,1,1,0,37
50,24,26,1,93,1,1,0,69
0,0,0,1,93,1,1,0,67
72,39,33,1,93,1,1,0,196
54,28,26,1,93,1,1,0,177
109,88,21,1,93,1,1,0,384
53,32,21,1,93,1,1,0,158
17,9,8,1,93,1,1,0,87
0,0,0,1,93,1,1,0,44
64,32,32,1,93,1,1,0,240
62,30,32,1,93,1,1,0,237
58,25,33,1,93,1,1,0,551
7,5,2,1,93,1,1,0,207
106,39,67,1,93,1,1,0,369
59,23,36,1,93,1,1,0,250
8,7,1,1,93,1,1,0,111
65,27,38,1,93,1,1,0,459
0,0,0,1,93,1,1,0,71
49,21,28,1,93,1,1,0,251
69,63,6,1,93,1,1,0,241
100,51,49,1,93,1,1,0,334
0,0,0,1,93,1,1,0,298
326,222,104,1,93,1,1,0,316
75,6,69,1,93,1,1,0,241
27,17,10,1,93,1,1,0,1391
22,17,5,1,93,1,1,0,111
38,21,17,1,93,1,1,0,252
0,0,0,1,93,1,1,0,84
8,7,1,1,93,1,1,0,160
2,1,1,1,93,1,1,0,103
95,57,38,1,93,1,1,0,80
91,90,1,1,93,1,1,0,676
350,304,46,1,93,1,1,0,567
36,24,12,1,93,1,1,0,100
13,13,0,1,93,1,1,0,72
38,30,8,1,93,1,1,0,352
181,164,17,1,93,1,1,0,1177
14,7,7,1,93,1,1,0,110
638,638,0,1,93,1,1,0,694
68,45,23,1,93,1,1,0,476
42,28,14,1,93,1,1,0,117
24,12,12,1,93,1,1,0,137
7,7,0,1,93,1,1,0,624
14,7,7,1,93,1,1,0,71
14,14,0,1,93,1,1,0,73
19,12,7,1,93,1,1,0,81
2,2,0,1,93,1,1,0,223
0,0,0,1,93,1,1,0,0
50,46,4,1,93,1,1,0,189
17,9,8,1,93,1,1,0,249
2,1,1,1,93,1,1,0,139
7,3,4,1,93,1,1,0,43
181,93,88,1,93,1,1,0,194
2,1,1,1,93,1,1,0,393
7,3,4,1,93,1,1,0,408
126,80,46,1,93,1,1,0,519
5,2,3,1,93,1,1,0,79
1,0,1,1,93,1,1,0,96
13,3,10,1,93,1,1,0,716
2,0,2,1,93,1,1,0,146
3,0,3,1,93,1,1,0,155
8,8,0,1,93,1,1,0,59
13,13,0,1,93,1,1,0,54
0,0,0,1,93,1,1,0,32
19,13,6,1,93,1,1,0,82
7,4,3,1,93,1,1,0,119
99,99,0,1,93,1,1,0,134
20,16,4,1,93,1,1,0,88
0,0,0,1,93,1,1,0,142
42,21,21,1,93,1,1,0,335
39,36,3,1,93,1,1,0,506
238,152,86,1,93,1,1,0,634
23,21,2,1,93,1,1,0,188
787,398,389,1,93,1,1,0,1777
50,41,9,1,93,1,1,0,235
92,74,18,1,93,1,1,0,374
60,37,23,1,93,1,1,0,86
52,30,22,1,93,1,1,0,162
154,107,47,1,93,1,1,0,809
111,76,35,1,93,1,1,0,721
25,16,9,1,93,1,1,0,125
0,0,0,1,93,1,1,0,101
10,7,3,1,93,1,1,0,216
10,7,3,1,93,1,1,0,97
41,17,24,1,93,1,1,0,334
18,0,18,1,93,1,1,0,186
42,35,7,1,93,1,1,0,124
90,61,29,1,93,1,1,0,218
13,0,13,1,93,1,1,0,146
38,22,16,1,93,1,1,0,114
0,0,0,1,93,1,1,0,469
0,0,0,1,93,1,1,0,0
2,1,1,1,93,1,1,0,49
16,9,7,1,93,1,1,0,31
35,17,18,1,93,1,1,0,558
25,1,24,1,93,1,1,0,215
116,75,41,1,93,1,1,0,409
88,0,88,1,93,1,1,0,133
237,166,71,1,93,1,1,0,344
20,11,9,1,93,1,1,0,170
82,63,19,1,93,1,1,0,290
29,19,10,1,93,1,1,0,135
157,82,75,1,93,1,1,0,611
714,522,192,1,93,1,1,0,1083
30,14,16,1,93,1,1,0,158
4,2,2,1,93,1,1,0,144
94,70,24,1,93,1,1,0,1288
6,3,3,1,93,1,1,0,105
885,528,357,1,93,1,1,0,1579
94,35,59,1,93,1,1,0,218
52,33,19,1,93,1,1,0,324
356,262,94,1,93,1,1,0,609
4,2,2,1,93,1,1,0,103
119,63,56,1,93,1,1,0,586
300,96,204,1,93,1,1,0,255
192,142,50,1,93,1,1,0,482
6,3,3,1,93,1,1,0,85
80,66,14,1,93,1,1,0,486
6,3,3,1,93,1,1,0,114
583,471,112,1,93,1,1,0,941
14,6,8,1,93,1,1,0,137
3,2,1,1,93,1,1,0,63
0,0,0,1,93,1,1,0,662
8,4,4,1,93,1,1,0,193
0,0,0,1,93,1,1,0,235
7,3,4,1,93,1,1,0,351
68,27,41,1,93,1,1,0,413
70,56,14,1,93,1,1,0,404
24,12,12,1,93,1,1,0,207
69,28,41,1,93,1,1,0,1239
0,0,0,1,93,1,1,0,85
111,56,55,1,93,1,1,0,316
14,7,7,1,93,1,1,0,98
16,7,9,1,93,1,1,0,421
47,21,26,1,93,1,1,0,1102
16,7,9,1,93,1,1,0,266
14,7,7,1,93,1,1,0,377
0,0,0,1,93,1,1,0,749
0,0,0,1,93,1,1,0,186
2014,1244,770,1,93,1,1,0,5955
57,39,18,1,93,1,1,0,164
308,159,149,1,93,1,1,0,1364
0,0,0,1,93,1,1,0,183
0,0,0,1,93,1,1,0,191
267,44,223,1,93,1,1,0,1388
0,0,0,1,93,1,1,0,0
0,0,0,1,93,1,1,0,0
0,0,0,1,93,1,1,0,0
0,0,0,1,93,1,1,0,0
0,0,0,1,93,1,1,0,0
0,0,0,1,93,1,1,0,0
0,0,0,1,93,1,1,0,0
0,0,0,1,93,1,1,0,0
0,0,0,1,93,1,1,0,0
0,0,0,1,93,1,1,0,0
0,0,0,1,93,1,1,0,0
0,0,0,1,93,1,1,0,0
0,0,0,1,93,1,1,0,0
0,0,0,1,93,1,1,0,0
171,107,64,1,93,1,1,0,980
17,9,8,1,93,1,1,0,184
0,0,0,1,93,1,1,0,285
6,3,3,1,93,1,1,0,59
0,0,0,1,93,1,1,0,0
0,0,0,1,93,1,1,0,0
0,0,0,1,93,1,1,0,0
0,0,0,1,93,1,1,0,0
0,0,0,1,93,1,1,0,0
0,0,0,1,93,1,1,0,0
0,0,0,1,93,1,1,0,0
0,0,0,1,93,1,1,0,0
0,0,0,1,93,1,1,0,0
0,0,0,1,93,1,1,0,0
0,0,0,1,93,1,1,0,0
0,0,0,1,93,1,1,0,0
0,0,0,1,93,1,1,0,0
238,150,88,1,93,1,1,0,1339
5,3,2,1,93,1,1,0,116
276,176,100,1,93,1,1,0,224
0,0,0,1,93,1,1,0,177
6,5,1,1,93,1,1,0,425
217,137,80,1,93,1,1,0,609
18,10,8,1,93,1,1,0,100
21,11,10,1,93,1,1,0,188
482,359,123,1,93,1,1,0,664
120,15,105,1,93,1,1,0,227
4,2,2,1,93,1,1,0,205
4,2,2,1,93,1,1,0,78
44,21,23,1,93,1,1,0,1090
15,8,7,1,93,1,1,0,251
0,0,0,1,93,1,1,0,0
0,0,0,1,93,1,1,0,0
56,29,27,1,93,1,1,0,212
7,2,5,1,93,1,1,0,27
39,19,20,1,93,1,1,0,398
405,299,106,1,93,1,1,0,1447
0,0,0,1,93,1,1,0,480
64,37,27,1,93,1,1,0,538
205,119,86,1,93,1,1,0,443
26,24,2,1,93,1,1,0,138
253,133,120,1,93,1,1,0,886
445,171,274,1,93,1,1,0,2008
5,3,2,1,93,1,1,0,64
39,17,22,1,93,1,1,0,784
0,0,0,1,93,1,1,0,354
232,63,169,1,93,1,1,0,223
230,174,56,1,93,1,1,0,651
375,311,64,1,93,1,1,0,515
9,4,5,1,93,1,1,0,58
113,41,72,1,93,1,1,0,739
26,19,7,1,93,1,1,0,62
6,6,0,1,93,1,1,0,56
0,0,0,1,93,1,1,0,60
367,269,98,1,93,1,1,0,1573
450,380,70,1,93,1,1,0,842
6,3,3,1,93,1,1,0,80
370,327,43,1,93,1,1,0,581
9,4,5,1,93,1,1,0,45
90,88,2,1,93,1,1,0,224
256,117,139,1,93,1,1,0,372
252,205,47,1,93,1,1,0,445
274,163,111,1,93,1,1,0,933
0,0,0,1,93,1,1,0,0
17,8,9,1,93,1,1,0,188
8,6,2,1,93,1,1,0,246
11,10,1,1,93,1,1,0,616
13,4,9,1,93,1,1,0,460
31,31,0,1,93,1,1,0,89
115,41,74,1,93,1,1,0,412
10,6,4,1,93,1,1,0,115
26,20,6,1,93,1,1,0,68
0,0,0,1,93,1,1,0,287
0,0,0,1,93,1,1,0,180
112,39,73,1,93,1,1,0,694
114,36,78,1,93,1,1,0,1423
69,45,24,1,93,1,1,0,295
415,173,242,1,93,1,1,0,841
8,1,7,1,93,1,1,0,175
0,0,0,1,93,1,1,0,1048
147,86,61,1,93,1,1,0,1533
0,0,0,1,93,1,1,0,0
74,51,23,1,93,1,1,0,942
155,155,0,1,93,1,1,0,196
76,50,26,1,93,1,1,0,384
0,0,0,1,93,1,1,0,1014
0,0,0,1,93,1,1,0,336
39,18,21,1,93,1,1,0,586
12,4,8,1,93,1,1,0,67
124,84,40,1,93,1,1,0,620
21,13,8,1,93,1,1,0,197
0,0,0,1,93,1,1,0,0
1008,847,161,1,93,1,1,0,7222
725,473,252,1,93,1,1,0,1241
280,136,144,1,93,1,1,0,346
0,0,0,1,93,1,1,0,0
512,328,184,1,93,1,1,0,896
40,26,14,1,93,1,1,0,142
547,410,137,1,93,1,1,0,3410
85,62,23,1,93,1,1,0,1427
222,167,55,1,93,1,1,0,2474
96,54,42,1,93,1,1,0,1114
36,21,15,1,93,1,1,0,742
25,16,9,1,93,1,1,0,482
4,2,2,1,93,1,1,0,290
412,254,158,1,93,1,1,0,2562
0,0,0,1,93,1,1,0,0
0,0,0,1,93,1,1,0,114
76,54,22,1,93,1,1,0,636
1,0,1,1,93,1,1,0,268
539,481,58,1,93,1,1,0,2019
431,328,103,1,93,1,1,0,672
33,17,16,1,93,1,1,0,122
841,472,369,1,93,1,1,0.000155183116076971,6444
3049,1566,1483,1,93,1,1,0,6253
311,173,138,1,93,1,1,0,537
1134,472,662,1,93,1,1,0,2553
4,2,2,1,93,1,1,0,301
439,323,116,1,93,1,1,0,2927
0,0,0,1,93,1,1,0,23
16,9,7,1,93,1,1,0,451
0,0,0,1,93,1,1,0,0
1966,489,1477,1,93,1,1,0,1844
100,18,82,1,93,1,1,0,188
116,87,29,1,93,1,1,0,582
7,5,2,1,93,1,1,0,229
294,142,152,1,93,1,1,0,517
27,14,13,1,93,1,1,0,50
0,0,0,1,93,1,1,0,1097
0,0,0,1,93,1,1,0,321
0,0,0,1,93,1,1,0,817
0,0,0,1,93,1,1,0,99
24,16,8,1,93,1,1,0,240
38,27,11,1,93,1,1,0,758
31,13,18,1,93,1,1,0,1045
50,19,31,1,93,1,1,0,653
193,144,49,1,93,1,1,0,421
733,418,315,1,93,1,1,0,1005
454,420,34,1,93,1,1,0,1498
31,9,22,1,93,1,1,0,205
3,1,2,1,93,1,1,0,283
7,6,1,1,93,1,1,0,500
2702,1400,1302,1,93,1,1,0,2552
7,3,4,1,93,1,1,0,32
105,78,27,1,93,1,1,0,1131
4,4,0,1,93,1,1,0,254
0,0,0,1,93,1,1,0,0
0,0,0,1,93,1,1,0,0
0,0,0,1,93,1,1,0,0
0,0,0,1,93,1,1,0,0
14,13,1,1,93,1,1,0,161
74,56,18,1,93,1,1,0,833
34,28,6,1,93,1,1,0,237
17,10,7,1,93,1,1,0,212
495,20,475,1,93,1,1,0,597
16,0,16,1,93,1,1,0,71
437,75,362,1,93,1,1,0,1304
8,3,5,1,93,1,1,0,727
68,43,25,1,93,1,1,0,192
0,0,0,1,93,1,1,0,973
10,5,5,1,93,1,1,0,104
3,1,2,1,93,1,1,0,37
13,3,10,1,93,1,1,0,51
133,89,44,1,93,1,1,0,707
1944,803,1141,1,93,1,1,0,1085
8,4,4,1,93,1,1,0,30
251,227,24,1,93,1,1,0,265
0,0,0,1,93,1,1,0,21
0,0,0,1,93,1,1,0,408
155,125,30,1,93,1,1,0,382
17,17,0,1,93,1,1,0,66
0,0,0,1,93,1,1,0,21
0,0,0,1,93,1,1,0,208
584,419,165,1,93,1,1,0,678
16,14,2,1,93,1,1,0,89
0,0,0,1,93,1,1,0,87
0,0,0,1,93,1,1,0,15
23,0,23,1,93,1,1,0,22
0,0,0,1,93,1,1,0,76
114,57,57,1,93,1,1,0,135
33,24,9,1,93,1,1,0,286
26,25,1,1,93,1,1,0,65
12,12,0,1,93,1,1,0,67
9,6,3,1,93,1,1,0,36
0,0,0,1,93,1,1,0,1229
5,4,1,1,93,1,1,0,22
0,0,0,1,93,1,1,0,774
0,0,0,1,93,1,1,0,349
294,146,148,1,93,1,1,0,3563
101,50,51,1,93,1,1,0,2858
24,6,18,1,93,1,1,0,174
6,4,2,1,93,1,1,0,1239
124,52,72,1,93,1,1,0,652
0,0,0,1,93,1,1,0,204
0,0,0,1,93,1,1,0,357
14,10,4,1,93,1,1,0,134
4,2,2,1,93,1,1,0,114
514,301,213,1,93,1,1,0,648
63,42,21,1,93,1,1,0,95
26,17,9,1,93,1,1,0,271
119,77,42,1,93,1,1,0,406
45,23,22,1,93,1,1,0,176
245,132,113,1,93,1,1,0,297
40,30,10,2,18,2,1,0,134
4,2,2,1,93,1,1,0,168
0,0,0,1,93,1,1,0,0
9,6,3,1,93,1,1,0,226
23,13,10,1,93,1,1,0,40
10,9,1,1,93,1,1,0,229
79,47,32,1,93,1,1,0,148
2,1,1,1,93,1,1,0,35
51,44,7,1,93,1,1,0,392
10,10,0,1,93,1,1,0,65
510,256,254,1,93,1,1,0,393
246,183,63,1,93,1,1,0,594
8,4,4,1,93,1,1,0,140
12,5,7,1,93,1,1,0,45
202,137,65,1,93,1,1,0,698
16,6,10,1,93,1,1,0,75
67,27,40,2,93,2,1,0,168
3,3,0,1,93,1,1,0,74
69,33,36,1,93,1,1,0,264
6,1,5,1,93,1,1,0,56
18,2,16,1,93,1,1,0,157
0,0,0,1,93,1,1,0,64
5,5,0,1,93,1,1,0,85
0,0,0,1,93,1,1,0,54
0,0,0,1,93,1,1,0,0
0,0,0,1,93,1,1,0,0
0,0,0,1,93,1,1,0,0
0,0,0,1,93,1,1,0,0
0,0,0,1,93,1,1,0,0
0,0,0,1,93,1,1,0,0
0,0,0,1,93,1,1,0,0
0,0,0,1,93,1,1,0,0
0,0,0,1,93,1,1,0,0
0,0,0,1,93,1,1,0,0
0,0,0,1,93,1,1,0,0
0,0,0,1,93,1,1,0,0
0,0,0,1,93,1,1,0,0
0,0,0,1,93,1,1,0,0
0,0,0,1,93,1,1,0,0
0,0,0,1,93,1,1,0,0
0,0,0,1,93,1,1,0,0
0,0,0,1,93,1,1,0,0
0,0,0,1,93,1,1,0,0
0,0,0,1,93,1,1,0,0
0,0,0,1,93,1,1,0,0
0,0,0,1,93,1,1,0,0
0,0,0,1,93,1,1,0,0
0,0,0,1,93,1,1,0,0
0,0,0,1,93,1,1,0,0
0,0,0,1,93,1,1,0,0
0,0,0,1,93,1,1,0,0
0,0,0,1,93,1,1,0,0
0,0,0,1,93,1,1,0,0
0,0,0,1,93,1,1,0,0
0,0,0,1,93,1,1,0,0
0,0,0,1,93,1,1,0,0
0,0,0,1,93,1,1,0,0
0,0,0,1,93,1,1,0,0
0,0,0,1,93,1,1,0,0
0,0,0,1,93,1,1,0,0
0,0,0,1,93,1,1,0,0
0,0,0,1,93,1,1,0,0
0,0,0,1,93,1,1,0,0
0,0,0,1,93,1,1,0,0
0,0,0,1,93,1,1,0,0
0,0,0,1,93,1,1,0,0
0,0,0,1,93,1,1,0,0
0,0,0,1,93,1,1,0,0
0,0,0,1,93,1,1,0,0
0,0,0,1,93,1,1,0,0
0,0,0,1,93,1,1,0,0
0,0,0,1,93,1,1,0,0
0,0,0,1,93,1,1,0,0
0,0,0,1,93,1,1,0,0
0,0,0,1,93,1,1,0,0
0,0,0,1,93,1,1,0,0
104,85,19,1,93,1,1,0,245
0,0,0,1,93,1,1,0,0
9,5,4,1,93,1,1,0,174
12,7,5,1,93,1,1,0,252
2,1,1,1,93,1,1,0,306
37,19,18,1,93,1,1,0,1093
396,225,171,1,93,1,1,0,5606
130,68,62,1,93,1,1,0,482
310,87,223,1,93,1,1,0,636
47,16,31,1,93,1,1,0,142
2,0,2,1,93,1,1,0,57
30,29,1,1,93,1,1,0,132
292,80,212,1,93,1,1,0,1625
8,2,6,1,93,1,1,0,94
0,0,0,1,93,1,1,0,23
0,0,0,1,93,1,1,0,31
5,3,2,1,93,1,1,0,118
9,7,2,1,93,1,1,0,91
34,15,19,1,93,1,1,0,383
68,31,37,1,93,1,1,0,635
4,4,0,1,93,1,1,0,99
47,25,22,1,93,1,1,0,343
83,61,22,1,93,1,1,0,304
32,18,14,1,93,1,1,0,149
0,0,0,1,93,1,1,0,0
0,0,0,1,93,1,1,0,0
0,0,0,1,93,1,1,0,0
0,0,0,1,93,1,1,0,0
0,0,0,1,93,1,1,0,0
0,0,0,1,93,1,1,0,0
0,0,0,1,93,1,1,0,0
0,0,0,1,93,1,1,0,0
0,0,0,1,93,1,1,0,0
0,0,0,1,93,1,1,0,0
0,0,0,1,93,1,1,0,0
0,0,0,1,93,1,1,0,0
0,0,0,1,93,1,1,0,0
0,0,0,1,93,1,1,0,0
0,0,0,1,93,1,1,0,0
0,0,0,1,93,1,1,0,506
17,9,8,1,93,1,1,0,90
321,315,6,1,93,1,1,0,343
0,0,0,1,93,1,1,0,727
0,0,0,1,93,1,1,0,89
0,0,0,1,93,1,1,0,0
73,1,72,1,93,1,1,0,20
27,12,15,1,93,1,1,0,46
171,141,30,1,93,1,1,0,984
1,0,1,1,93,1,1,0,152
678,447,231,1,93,1,1,0,1948
4,3,1,1,93,1,1,0,27
589,483,106,1,93,1,1,0,1584
0,0,0,1,93,1,1,0,0
347,204,143,1,93,1,1,0,1993
3325,2193,1132,1,93,1,1,0,11414
320,182,138,1,93,1,1,0.0011454753722795,873
41,14,27,1,93,1,1,0,159
1481,501,980,1,93,1,1,0,3154
221,175,46,1,93,1,1,0,868
7,7,0,1,93,1,1,0,566
14,8,6,1,93,1,1,0,113
2,1,1,1,93,1,1,0,38
587,462,125,1,93,1,1,0,982
0,0,0,1,93,1,1,0,609
0,0,0,1,93,1,1,0,54
0,0,0,1,93,1,1,0,0
0,0,0,1,93,1,1,0,0
36,33,3,1,93,1,1,0,135
423,248,175,1,93,1,1,0,1607
27,5,22,1,93,1,1,0,158
0,0,0,1,93,1,1,0,243
0,0,0,1,93,1,1,0,59
0,0,0,1,93,1,1,0,155
93,46,47,1,93,1,1,0,371
71,46,25,1,93,1,1,0,263
78,60,18,1,93,1,1,0,250
10,8,2,1,93,1,1,0,97
16,8,8,1,93,1,1,0,118
10,5,5,1,93,1,1,0,54
15,8,7,1,93,1,1,0,65
66,40,26,1,93,1,1,0,889
34,30,4,1,93,1,1,0,142
157,77,80,1,93,1,1,0,939
4,2,2,1,93,1,1,0,106
157,32,125,1,93,1,1,0,82
56,28,28,1,93,1,1,0,391
5,3,2,1,93,1,1,0,209
329,176,153,1,93,1,1,0,2576
15,8,7,1,93,1,1,0,277
9,9,0,1,93,1,1,0,84
14,10,4,1,93,1,1,0,80
14,10,4,1,93,1,1,0,111
117,85,32,1,93,1,1,0,548
12,8,4,1,93,1,1,0,190
23,11,12,1,93,1,1,0,241
22,13,9,1,93,1,1,0,545
730,359,371,1,93,1,1,0,652
28,16,12,1,93,1,1,0,180
90,58,32,1,93,1,1,0,216
37,19,18,1,93,1,1,0,252
6,3,3,1,93,1,1,0,71
151,130,21,1,93,1,1,0,400
46,17,29,1,93,1,1,0,352
0,0,0,1,93,1,1,0,0
0,0,0,1,93,1,1,0,0
0,0,0,1,93,1,1,0,0
0,0,0,1,93,1,1,0,0
0,0,0,1,93,1,1,0,0
0,0,0,1,93,1,1,0,0
0,0,0,1,93,1,1,0,0
0,0,0,1,93,1,1,0,0
0,0,0,1,93,1,1,0,0
0,0,0,1,93,1,1,0,0
0,0,0,1,93,1,1,0,0
0,0,0,1,93,1,1,0,0
0,0,0,1,93,1,1,0,0
0,0,0,1,93,1,1,0,0
0,0,0,1,93,1,1,0,0
6,3,3,1,93,1,1,0,114
16,8,8,1,93,1,1,0,218
12,6,6,1,93,1,1,0,131
0,0,0,1,93,1,1,0,0
6,3,3,1,93,1,1,0,95
6,3,3,1,93,1,1,0,147
90,75,15,1,93,1,1,0,981
6,3,3,1,93,1,1,0,89
0,0,0,1,93,1,1,0,200
10,5,5,1,93,1,1,0,132
66,34,32,1,93,1,1,0,575
6,3,3,1,93,1,1,0,81
113,62,51,1,93,1,1,0,2319
574,414,160,1,93,1,1,0,1034
268,221,47,1,93,1,1,0,1706
726,382,344,1,93,1,1,0,917
13,7,6,1,93,1,1,0,233
55,37,18,1,93,1,1,0,1270
38,29,9,1,93,1,1,0,423
1088,812,276,1,93,1,1,0,3833
22,9,13,1,93,1,1,0,153
333,152,181,1,93,1,1,0,1051
0,0,0,1,93,1,1,0,161
78,47,31,1,93,1,1,0,801
10,6,4,1,93,1,1,0,1075
17,9,8,1,93,1,1,0,130
136,81,55,1,93,1,1,0,1997
0,0,0,1,93,1,1,0,0
11,11,0,1,93,1,1,0,118
2845,1470,1375,1,93,1,1,0,1835
44,30,14,1,93,1,1,0,327
9,5,4,1,93,1,1,0,157
288,179,109,1,93,1,1,0,2201
0,0,0,1,93,1,1,0,266
9,5,4,1,93,1,1,0,371
186,112,74,1,93,1,1,0,535
36,19,17,1,93,1,1,0,598
163,17,146,1,93,1,1,0,551
7,4,3,1,93,1,1,0,182
35,20,15,1,93,1,1,0,443
245,224,21,1,93,1,1,0,527
170,85,85,1,93,1,1,0,580
33,16,17,1,93,1,1,0,151
40,25,15,1,93,1,1,0,137
2,1,1,1,93,1,1,0,795
22,11,11,1,93,1,1,0,146
102,64,38,1,93,1,1,0,668
8,4,4,1,93,1,1,0,63
38,15,23,1,93,1,1,0,266
121,11,110,1,93,1,1,0,647
93,61,32,1,93,1,1,0,762
34,17,17,1,93,1,1,0,378
199,89,110,1,93,1,1,0,608
16,7,9,1,93,1,1,0,320
7,3,4,1,93,1,1,0,89
33,15,18,1,93,1,1,0,1053
352,150,202,1,93,1,1,0,344
0,0,0,1,93,1,1,0,0
154,123,31,1,93,1,1,0,2207
6,3,3,1,93,1,1,0,141
86,63,23,1,93,1,1,0,177
238,130,108,1,93,1,1,0,2160
446,432,14,1,93,1,1,0,951
11,11,0,1,93,1,1,0,309
53,10,43,1,93,1,1,0,2259
170,48,122,1,93,1,1,0,2209
16,6,10,1,93,1,1,0,835
124,79,45,1,93,1,1,0,2249
0,0,0,1,93,1,1,0,288
153,84,69,1,93,1,1,0,360
18,11,7,1,93,1,1,0,418
13,10,3,1,93,1,1,0,310
13,0,13,1,93,1,1,0,38
2,1,1,1,93,1,1,0,238
26,18,8,1,93,1,1,0,454
198,78,120,1,93,1,1,0,3374
9,4,5,1,93,1,1,0,73
107,95,12,1,93,1,1,0,127
7,4,3,1,93,1,1,0,104
52,46,6,1,93,1,1,0,244
5,4,1,1,93,1,1,0,92
311,158,153,1,93,1,1,0,565
32,22,10,1,93,1,1,0,471
302,78,224,1,93,1,1,0,294
461,264,197,1,93,1,1,0,1809
0,0,0,1,93,1,1,0,159
28,15,13,1,93,1,1,0,101
283,85,198,1,93,1,1,0,1210
6,4,2,1,93,1,1,0,169
72,24,48,1,93,1,1,0,425
19,16,3,1,93,1,1,0,246
51,39,12,1,93,1,1,0,625
12,3,9,1,93,1,1,0,117
6,6,0,1,93,1,1,0,208
362,189,173,1,93,1,1,0,1978
0,0,0,1,93,1,1,0,0
0,0,0,1,93,1,1,0,0
0,0,0,1,93,1,1,0,0
0,0,0,1,93,1,1,0,0
0,0,0,1,93,1,1,0,0
0,0,0,1,93,1,1,0,0
0,0,0,1,93,1,1,0,0
0,0,0,1,93,1,1,0,0
0,0,0,1,93,1,1,0,0
0,0,0,1,93,1,1,0,0
0,0,0,1,93,1,1,0,0
0,0,0,1,93,1,1,0,0
0,0,0,1,93,1,1,0,0
0,0,0,1,93,1,1,0,0
0,0,0,1,93,1,1,0,0
0,0,0,1,93,1,1,0,0
0,0,0,1,93,1,1,0,0
0,0,0,1,93,1,1,0,0
0,0,0,1,93,1,1,0,0
0,0,0,1,93,1,1,0,0
0,0,0,1,93,1,1,0,0
0,0,0,1,93,1,1,0,0
0,0,0,1,93,1,1,0,0
0,0,0,1,93,1,1,0,0
0,0,0,1,93,1,1,0,0
0,0,0,1,93,1,1,0,0
0,0,0,1,93,1,1,0,0
0,0,0,1,93,1,1,0,0
0,0,0,1,93,1,1,0,0
0,0,0,1,93,1,1,0,0
0,0,0,1,93,1,1,0,0
0,0,0,1,93,1,1,0,0
0,0,0,1,93,1,1,0,0
0,0,0,1,93,1,1,0,0
0,0,0,1,93,1,1,0,0
0,0,0,1,93,1,1,0,0
0,0,0,1,93,1,1,0,0
0,0,0,1,93,1,1,0,0
0,0,0,1,93,1,1,0,0
0,0,0,1,93,1,1,0,0
0,0,0,1,93,1,1,0,0
0,0,0,1,93,1,1,0,0
0,0,0,1,93,1,1,0,0
0,0,0,1,93,1,1,0,0
0,0,0,1,93,1,1,0,0
0,0,0,1,93,1,1,0,0
0,0,0,1,93,1,1,0,0
0,0,0,1,93,1,1,0,0
0,0,0,1,93,1,1,0,0
0,0,0,1,93,1,1,0,0
0,0,0,1,93,1,1,0,0
0,0,0,1,93,1,1,0,0
0,0,0,1,93,1,1,0,0
0,0,0,1,93,1,1,0,0
0,0,0,1,93,1,1,0,0
27,19,8,1,93,1,1,0,836
0,0,0,1,93,1,1,0,0
0,0,0,1,93,1,1,0,0
0,0,0,1,93,1,1,0,1878
0,0,0,1,93,1,1,0,50
224,195,29,1,93,1,1,0,1811
16,8,8,1,93,1,1,0,548
1,1,0,1,93,1,1,0,265
2,2,0,1,93,1,1,0,212
0,0,0,1,93,1,1,0,165
0,0,0,1,93,1,1,0,84
0,0,0,1,93,1,1,0,638
0,0,0,1,93,1,1,0,88
126,121,5,1,93,1,1,0,286
52,10,42,1,93,1,1,0,224
1721,1054,667,1,93,1,1,0,3021
247,175,72,1,93,1,1,0,748
93,55,38,1,93,1,1,0,306
15,14,1,1,93,1,1,0,197
2,1,1,1,93,1,1,0,87
36,35,1,1,93,1,1,0,95
250,129,121,1,93,1,1,0,568
74,47,27,1,93,1,1,0,262
130,23,107,1,93,1,1,0,155
2,0,2,1,93,1,1,0,38
19,9,10,1,93,1,1,0,401
8,5,3,1,93,1,1,0,1114
64,40,24,1,93,1,1,0,795
140,84,56,1,93,1,1,0,910
17,11,6,1,93,1,1,0,514
12,10,2,1,93,1,1,0,137
657,428,229,1,93,1,1,0,864
3,0,3,1,93,1,1,0,34
117,67,50,1,93,1,1,0,651
13,3,10,1,93,1,1,0,48
106,21,85,1,93,1,1,0,335
2,0,2,1,93,1,1,0,66
36,28,8,1,93,1,1,0,751
3,3,0,1,93,1,1,0,63
646,341,305,1,93,1,1,0,3110
0,0,0,1,93,1,1,0,1207
0,0,0,1,93,1,1,0,122
92,51,41,1,93,1,1,0,1588
28,18,10,1,93,1,1,0,1497
538,318,220,1,93,1,1,0,1017
44,34,10,1,93,1,1,0,605
3,2,1,1,93,1,1,0,65
165,119,46,1,93,1,1,0,2123
11,5,6,1,93,1,1,0,112
174,111,63,2,93,1,1,0,356
4,2,2,1,93,1,1,0,603
32,25,7,1,93,1,1,0,983
2,2,0,1,93,1,1,0,239
6,4,2,1,93,1,1,0,50
0,0,0,1,93,1,1,0,0
0,0,0,1,93,1,1,0,4
0,0,0,1,93,1,1,0,2
23,20,3,1,93,1,1,0,112
1,0,1,1,93,1,1,0,2
0,0,0,1,93,1,1,0,30
7,7,0,1,93,1,1,0,353
31,25,6,1,93,1,1,0,221
169,110,59,1,93,1,1,0,586
9,5,4,1,93,1,1,0,101
76,69,7,1,93,1,1,0,648
0,0,0,1,93,1,1,0,0
0,0,0,1,93,1,1,0,0
0,0,0,1,93,1,1,0,0
0,0,0,1,93,1,1,0,0
0,0,0,1,93,1,1,0,0
0,0,0,1,93,1,1,0,0
0,0,0,1,93,1,1,0,0
0,0,0,1,93,1,1,0,0
0,0,0,1,93,1,1,0,0
0,0,0,1,93,1,1,0,0
0,0,0,1,93,1,1,0,0
0,0,0,1,93,1,1,0,0
0,0,0,1,93,1,1,0,0
0,0,0,1,93,1,1,0,0
0,0,0,1,93,1,1,0,0
0,0,0,1,93,1,1,0,0
0,0,0,1,93,1,1,0,0
0,0,0,1,93,1,1,0,0
0,0,0,1,93,1,1,0,0
0,0,0,1,93,1,1,0,0
0,0,0,1,93,1,1,0,0
0,0,0,1,93,1,1,0,0
0,0,0,1,93,1,1,0,0
0,0,0,1,93,1,1,0,0
0,0,0,1,93,1,1,0,0
0,0,0,1,93,1,1,0,0
0,0,0,1,93,1,1,0,0
0,0,0,1,93,1,1,0,0
6,3,3,1,93,0,0,0,33
29,11,18,1,93,0,0,0,29
4,2,2,1,95,1,0,0,718
5,5,0,2,55,2,0,0.00133689839572193,748
34,34,0,4,61,0,0,0.00302114803625378,331
2,0,2,1,158,0,0,0,134
18,14,4,2,20,1,0,0,681
3,2,1,1,21,1,0,0,43
22,13,9,3,17,3,0,0,1750
3,3,0,1,122,1,0,0.00151515151515152,660
14,11,3,2,112,1,0,0.00220264317180617,454
0,0,0,1,112,0,0,0.00980392156862745,102
17,11,6,3,111,2,0,0,66
24,11,13,1,39,0,0,0,249
3,2,1,1,116,1,0,0.00145772594752187,686
264,258,6,6,24,1,0,0,979
36,36,0,5,24,1,0,0,179
162,107,55,6,55,5,0,0,1851
7,4,3,4,55,4,0,0,103
4,4,0,1,3,1,0,0,401
444,298,146,13,4,3,0,0.0112359550561798,267
27,14,13,10,24,1,0,0,57
0,0,0,1,24,0,0,0,0
0,0,0,1,24,0,0,0,0
254,176,78,13,24,5,0,0.00116686114352392,857
15,6,9,4,24,2,0,0.00568181818181818,176
462,285,177,5,20,1,0,0,867
24,13,11,2,55,2,0,0,170
12,12,0,1,87,1,0,0,2003
2,1,1,1,87,1,0,0,299
21,21,0,1,140,1,0,0,1174
146,99,47,8,20,3,0,0.00273224043715847,1098
65,42,23,16,0,3,0,0.00168918918918919,592
79,69,10,5,34,2,0,0.00216919739696312,922
73,52,21,14,18,14,0,0.00156739811912226,1914
97,58,39,7,24,4,0,0.000757002271006813,2642
18,12,6,1,158,0,0,0,168
39,28,11,4,69,4,0,0.000645994832041344,1548
4,4,0,1,3,1,0,0.000634115409004439,1577
502,236,266,15,21,5,0,0.000938086303939962,3198
5,5,0,1,29,1,0,0,74
2,1,1,1,160,1,0,0,162
7,6,1,1,178,0,0,0,732
2,1,1,1,178,0,0,0,71
140,49,91,12,35,9,0,0.00357852882703777,2515
4,2,2,2,97,1,0,0,32
8,1,7,1,41,1,0,0,66
1,0,1,1,52,0,0,0,1183
4,3,1,1,0,1,0,0,1266
24,20,4,2,52,1,0,0.000959692898272553,1042
2,1,1,2,91,0,0,0,120
2,2,0,2,94,0,0,0,46
23,23,0,2,112,1,0,0.00536193029490617,373
1,1,0,1,144,0,0,0,58
25,18,7,11,18,4,0,0.00469043151969981,1066
8,6,2,1,90,0,0,0.00180831826401447,553
2,1,1,1,90,0,0,0,60
191,107,84,13,19,5,0,0.00249643366619116,2804
2,1,1,1,132,1,0,0,5
2,1,1,1,132,1,0,0,5
2,1,1,1,132,1,0,0,6
2,1,1,1,132,1,0,0,5
2,1,1,2,132,2,0,0,5
64,55,9,7,18,4,0,0,627
2,1,1,1,96,1,0,0,888
34,27,7,5,94,4,0,0.00533333333333333,375
13,7,6,2,132,1,0,0,563
2,1,1,1,112,1,0,0,9
4,2,2,1,140,0,0,0,1094
8,4,4,1,140,0,0,0,2034
6,3,3,1,140,0,0,0,514
4,2,2,1,140,0,0,0,1572
4,2,2,1,140,0,0,0,282
6,3,3,1,140,0,0,0,509
4,2,2,1,140,0,0,0,672
4,2,2,1,140,0,0,0,104
24,22,2,1,140,0,0,0,646
4,2,2,1,140,0,0,0,68
4,2,2,1,140,0,0,0,205
4,2,2,1,140,0,0,0,31
4,2,2,1,140,0,0,0,84
4,2,2,1,140,0,0,0,54
4,2,2,1,140,0,0,0,141
4,2,2,1,140,0,0,0,114
38,29,9,1,161,0,0,0,169
5,3,2,1,161,0,0,0,80
0,0,0,1,161,0,0,0,452
0,0,0,1,161,0,0,0,0
24,19,5,1,161,0,0,0,343
0,0,0,1,161,0,0,0,574
91,50,41,1,161,0,0,0,617
21,11,10,1,161,0,0,0,324
24,15,9,1,161,0,0,0,61
2,1,1,1,161,0,0,0,1157
6,3,3,1,161,0,0,0,186
0,0,0,1,161,0,0,0,0
17,8,9,1,161,0,0,0,131
220,139,81,1,161,0,0,0,235
181,153,28,1,161,0,0,0,200
309,214,95,1,161,0,0,0,389
15,11,4,1,161,0,0,0,28
141,102,39,1,161,0,0,0,648
131,109,22,1,161,0,0,0,507
30,15,15,1,161,0,0,0,281
8,4,4,1,161,0,0,0,31
1283,905,378,1,161,0,0,0,2125
127,105,22,1,161,0,0,0,437
1829,1307,522,1,161,0,0,0,2004
175,151,24,1,161,0,0,0,362
214,166,48,1,161,0,0,0,955
4,2,2,1,161,0,0,0,31
6,3,3,1,161,0,0,0,275
35,27,8,1,161,0,0,0,442
268,183,85,1,161,0,0,0,1834
35,23,12,1,161,0,0,0,342
4,2,2,1,161,0,0,0,565
0,0,0,1,161,0,0,0,569
44,26,18,1,161,0,0,0,701
1303,974,329,1,161,0,0,0,1058
93,62,31,1,161,0,0,0,89
24,19,5,1,161,0,0,0,205
2,1,1,1,161,0,0,0,404
0,0,0,1,161,0,0,0,25
0,0,0,1,161,0,0,0,132
0,0,0,1,161,0,0,0,0
0,0,0,1,161,0,0,0,537
0,0,0,1,161,0,0,0,653
0,0,0,1,161,0,0,0,531
93,51,42,1,161,0,0,0,632
80,51,29,1,161,0,0,0,340
4,2,2,1,161,0,0,0,11
282,197,85,1,161,0,0,0,1480
31,19,12,1,161,0,0,0,122
63,32,31,1,161,0,0,0,330
27,17,10,1,161,0,0,0,62
134,126,8,1,161,0,0,0,440
93,59,34,1,161,0,0,0,1244
4,2,2,1,161,0,0,0,128
4,1,3,1,161,0,0,0,59
190,143,47,1,161,0,0,0,428
0,0,0,1,161,0,0,0,0
1162,709,453,1,161,0,0,0,1613
32,16,16,1,161,0,0,0,318
63,34,29,1,161,0,0,0,274
22,11,11,10,0,1,0,0.0123022847100176,569
39,34,5,4,5,0,0,0.00314465408805031,318
10,5,5,3,55,0,0,0,79
0,0,0,1,101,0,0,0,20
902,678,224,29,3,7,0,0.0032520325203252,1230
3,2,1,2,89,0,0,0,26
130,82,48,11,18,1,0,0,125
8,7,1,3,101,0,0,0,0
0,0,0,1,101,0,0,0,53
129,92,37,5,28,0,0,0,107
1,1,0,2,55,0,0,0,28
75,37,38,6,37,2,0,0,451
0,0,0,1,101,0,0,0,0
0,0,0,1,101,0,0,0,0
190,118,72,5,101,1,0,0,0
0,0,0,1,101,0,0,0,0
0,0,0,1,101,0,0,0,0
11,10,1,3,18,1,0,0.00348432055749129,287
0,0,0,1,101,0,0,0,62
15,8,7,5,18,1,0,0,372
0,0,0,1,101,0,0,0,131
0,0,0,1,101,0,0,0,86
2,2,0,3,18,0,0,0,42
189,133,56,8,18,1,0,0.00331858407079646,904
7,7,0,2,87,0,0,0,91
0,0,0,1,101,0,0,0,1239
3,2,1,2,87,0,0,0.00218340611353712,458
0,0,0,1,101,0,0,0,46
23,18,5,3,18,1,0,0.00460829493087558,217
2,2,0,2,87,0,0,0,67
0,0,0,2,100,0,0,0,1
0,0,0,1,101,0,0,0,182
0,0,0,2,100,0,0,0,123
0,0,0,1,101,0,0,0,17
0,0,0,1,101,0,0,0,21
0,0,0,1,101,0,0,0,17
0,0,0,1,101,0,0,0,20
0,0,0,1,101,0,0,0,19
0,0,0,1,101,0,0,0,18
0,0,0,1,101,0,0,0,20
0,0,0,1,101,0,0,0,20
0,0,0,1,101,0,0,0,17
0,0,0,1,101,0,0,0,18
0,0,0,1,101,0,0,0,20
0,0,0,1,101,0,0,0,21
0,0,0,1,101,0,0,0,22
0,0,0,1,101,0,0,0,17
0,0,0,1,101,0,0,0,20
0,0,0,1,101,0,0,0,17
0,0,0,1,101,0,0,0,22
0,0,0,1,101,0,0,0,21
0,0,0,1,101,0,0,0,23
0,0,0,1,101,0,0,0,17
0,0,0,1,101,0,0,0,17
0,0,0,1,101,0,0,0,17
0,0,0,1,101,0,0,0,18
0,0,0,1,101,0,0,0,20
0,0,0,1,101,0,0,0,21
0,0,0,1,101,0,0,0,23
0,0,0,1,101,0,0,0,17
0,0,0,1,101,0,0,0,17
0,0,0,1,101,0,0,0,19
0,0,0,1,101,0,0,0,17
0,0,0,1,101,0,0,0,19
0,0,0,1,101,0,0,0,18
0,0,0,1,101,0,0,0,20
0,0,0,1,101,0,0,0,20
0,0,0,1,101,0,0,0,19
0,0,0,1,101,0,0,0,18
0,0,0,1,101,0,0,0,22
0,0,0,1,101,0,0,0,17
0,0,0,1,101,0,0,0,19
0,0,0,1,101,0,0,0,20
0,0,0,1,101,0,0,0,22
0,0,0,1,101,0,0,0,19
0,0,0,1,101,0,0,0,18
0,0,0,1,101,0,0,0,22
0,0,0,1,101,0,0,0,17
0,0,0,1,101,0,0,0,20
0,0,0,1,101,0,0,0,16
0,0,0,1,101,0,0,0,20
0,0,0,1,101,0,0,0,28
0,0,0,1,101,0,0,0,22
0,0,0,1,101,0,0,0,18
0,0,0,1,101,0,0,0,26
0,0,0,1,101,0,0,0,21
0,0,0,1,101,0,0,0,26
0,0,0,1,101,0,0,0,19
0,0,0,1,101,0,0,0,20
0,0,0,1,101,0,0,0,22
0,0,0,1,101,0,0,0,29
0,0,0,1,101,0,0,0,24
0,0,0,1,101,0,0,0,19
0,0,0,1,101,0,0,0,19
0,0,0,1,101,0,0,0,20
0,0,0,1,101,0,0,0,18
0,0,0,1,101,0,0,0,27
0,0,0,1,101,0,0,0,23
0,0,0,1,101,0,0,0,29
0,0,0,1,101,0,0,0,18
0,0,0,1,101,0,0,0,37
0,0,0,1,101,0,0,0,863
0,0,0,1,101,0,0,0,299
0,0,0,1,101,0,0,0,35
0,0,0,1,101,0,0,0,99
0,0,0,1,101,0,0,0,380
0,0,0,1,101,0,0,0,21
0,0,0,1,101,0,0,0,37
0,0,0,1,101,0,0,0,427
0,0,0,1,101,0,0,0,230
0,0,0,1,101,0,0,0,206
0,0,0,1,101,0,0,0,38
0,0,0,1,101,0,0,0,657
0,0,0,1,101,0,0,0,1046
0,0,0,1,101,0,0,0,114
0,0,0,1,101,0,0,0,388
0,0,0,1,101,0,0,0,89
0,0,0,1,101,0,0,0,138
0,0,0,1,101,0,0,0,448
0,0,0,1,101,0,0,0,73
0,0,0,1,101,0,0,0,173
0,0,0,1,101,0,0,0,182
0,0,0,1,101,0,0,0,75
0,0,0,1,101,0,0,0,49
0,0,0,1,101,0,0,0,180
0,0,0,1,101,0,0,0,253
0,0,0,1,101,0,0,0,62
0,0,0,1,101,0,0,0,71
0,0,0,1,101,0,0,0,95
0,0,0,1,101,0,0,0,144
0,0,0,1,101,0,0,0,82
0,0,0,1,101,0,0,0,244
0,0,0,1,101,0,0,0,51
0,0,0,1,101,0,0,0,112
0,0,0,1,101,0,0,0,134
0,0,0,1,101,0,0,0,95
0,0,0,1,101,0,0,0,332
0,0,0,1,101,0,0,0,39
0,0,0,1,101,0,0,0,882
0,0,0,1,101,0,0,0,82
0,0,0,1,101,0,0,0,42
0,0,0,1,101,0,0,0,116
0,0,0,1,101,0,0,0,86
0,0,0,1,101,0,0,0,88
0,0,0,1,101,0,0,0,157
0,0,0,1,101,0,0,0,180
0,0,0,1,101,0,0,0,588
0,0,0,1,101,0,0,0,90
0,0,0,1,101,0,0,0,219
0,0,0,1,101,0,0,0,18
0,0,0,1,101,0,0,0,281
0,0,0,1,101,0,0,0,193
0,0,0,1,101,0,0,0,177
0,0,0,1,101,0,0,0,110
0,0,0,1,101,0,0,0,230
0,0,0,1,101,0,0,0,1042
0,0,0,1,101,0,0,0,472
0,0,0,1,101,0,0,0,130
0,0,0,1,101,0,0,0,23
0,0,0,1,101,0,0,0,665
0,0,0,1,101,0,0,0,455
0,0,0,1,101,0,0,0,62
0,0,0,1,101,0,0,0,131
0,0,0,1,101,0,0,0,101
0,0,0,1,101,0,0,0,371
0,0,0,1,101,0,0,0,83
0,0,0,1,101,0,0,0,129
0,0,0,1,101,0,0,0,394
0,0,0,1,101,0,0,0,90
0,0,0,1,101,0,0,0,76
0,0,0,1,101,0,0,0,93
0,0,0,1,101,0,0,0,82
0,0,0,1,101,0,0,0,398
0,0,0,1,101,0,0,0,46
0,0,0,1,101,0,0,0,149
0,0,0,1,101,0,0,0,121
0,0,0,1,101,0,0,0,88
0,0,0,1,101,0,0,0,114
0,0,0,1,101,0,0,0,30
0,0,0,1,101,0,0,0,679
0,0,0,1,101,0,0,0,2151
0,0,0,2,100,0,0,0,119
0,0,0,1,101,0,0,0,74
0,0,0,1,101,0,0,0,164
0,0,0,2,100,0,0,0,230
0,0,0,1,101,0,0,0,53
0,0,0,1,101,0,0,0,84
0,0,0,1,101,0,0,0,61
0,0,0,1,101,0,0,0,85
0,0,0,1,101,0,0,0,202
0,0,0,1,101,0,0,0,170
0,0,0,1,101,0,0,0,172
0,0,0,1,101,0,0,0,377
0,0,0,1,101,0,0,0,45
0,0,0,1,101,0,0,0,81
0,0,0,1,101,0,0,0,126
0,0,0,1,101,0,0,0,171
0,0,0,1,101,0,0,0,1082
0,0,0,1,101,0,0,0,140
0,0,0,1,101,0,0,0,867
0,0,0,1,101,0,0,0,299
0,0,0,1,101,0,0,0,383
0,0,0,1,101,0,0,0,120
0,0,0,1,101,0,0,0,513
0,0,0,1,101,0,0,0,251
0,0,0,1,101,0,0,0,160
0,0,0,1,101,0,0,0,23
0,0,0,1,101,0,0,0,692
0,0,0,1,101,0,0,0,757
0,0,0,1,101,0,0,0,173
0,0,0,1,101,0,0,0,81
0,0,0,1,101,0,0,0,854
0,0,0,1,101,0,0,0,267
0,0,0,1,101,0,0,0,122
0,0,0,1,101,0,0,0,76
0,0,0,1,101,0,0,0,286
0,0,0,1,101,0,0,0,139
0,0,0,1,101,0,0,0,125
0,0,0,1,101,0,0,0,424
0,0,0,1,101,0,0,0,121
0,0,0,1,101,0,0,0,605
0,0,0,1,101,0,0,0,121
0,0,0,1,101,0,0,0,21
0,0,0,1,101,0,0,0,225
0,0,0,1,101,0,0,0,145
0,0,0,1,101,0,0,0,397
0,0,0,1,101,0,0,0,252
0,0,0,1,101,0,0,0,292
0,0,0,1,101,0,0,0,159
0,0,0,1,101,0,0,0,54
0,0,0,1,101,0,0,0,64
0,0,0,1,101,0,0,0,2031
0,0,0,1,101,0,0,0,22
0,0,0,1,101,0,0,0,93
0,0,0,1,101,0,0,0,133
0,0,0,1,101,0,0,0,207
0,0,0,1,101,0,0,0,163
0,0,0,1,101,0,0,0,205
0,0,0,1,101,0,0,0,152
0,0,0,1,101,0,0,0,270
0,0,0,1,101,0,0,0,144
0,0,0,1,101,0,0,0,443
0,0,0,1,101,0,0,0,68
0,0,0,1,101,0,0,0,26
0,0,0,1,101,0,0,0,39
0,0,0,1,101,0,0,0,32
0,0,0,1,101,0,0,0,49
0,0,0,1,101,0,0,0,25
0,0,0,1,101,0,0,0,41
0,0,0,1,101,0,0,0,47
0,0,0,1,101,0,0,0,36
0,0,0,1,101,0,0,0,35
0,0,0,1,101,0,0,0,30
0,0,0,1,101,0,0,0,27
0,0,0,1,101,0,0,0,81
0,0,0,1,101,0,0,0,55
0,0,0,1,101,0,0,0,78
0,0,0,1,101,0,0,0,236
0,0,0,1,101,0,0,0,74
0,0,0,1,101,0,0,0,32
0,0,0,1,101,0,0,0,164
0,0,0,1,101,0,0,0,62
0,0,0,1,101,0,0,0,71
0,0,0,1,101,0,0,0,65
0,0,0,1,101,0,0,0,69
0,0,0,1,101,0,0,0,80
0,0,0,1,101,0,0,0,22
0,0,0,1,101,0,0,0,101
0,0,0,1,101,0,0,0,52
0,0,0,1,101,0,0,0,1
0,0,0,1,101,0,0,0,93
0,0,0,1,101,0,0,0,158
0,0,0,1,101,0,0,0,78
0,0,0,1,101,0,0,0,65
0,0,0,1,101,0,0,0,51
0,0,0,1,101,0,0,0,24
0,0,0,1,101,0,0,0,84
0,0,0,1,101,0,0,0,175
0,0,0,1,101,0,0,0,70
0,0,0,1,101,0,0,0,55
0,0,0,1,101,0,0,0,32
0,0,0,1,101,0,0,0,95
0,0,0,1,101,0,0,0,51
0,0,0,1,101,0,0,0,1
0,0,0,1,101,0,0,0,38
0,0,0,1,101,0,0,0,53
0,0,0,1,101,0,0,0,157
0,0,0,1,101,0,0,0,1
0,0,0,1,101,0,0,0,107
0,0,0,1,101,0,0,0,74
0,0,0,1,101,0,0,0,98
0,0,0,1,101,0,0,0,62
0,0,0,1,101,0,0,0,115
0,0,0,1,101,0,0,0,22
0,0,0,1,101,0,0,0,71
0,0,0,1,101,0,0,0,164
0,0,0,1,101,0,0,0,186
0,0,0,1,101,0,0,0,100
0,0,0,1,101,0,0,0,71
0,0,0,1,101,0,0,0,105
0,0,0,1,101,0,0,0,31
0,0,0,1,101,0,0,0,37
0,0,0,1,101,0,0,0,45
0,0,0,1,101,0,0,0,40
0,0,0,1,101,0,0,0,365
0,0,0,1,101,0,0,0,73
0,0,0,1,101,0,0,0,28
0,0,0,1,101,0,0,0,129
0,0,0,1,101,0,0,0,43
0,0,0,1,101,0,0,0,138
0,0,0,1,101,0,0,0,74
0,0,0,1,101,0,0,0,76
0,0,0,1,101,0,0,0,75
0,0,0,1,101,0,0,0,106
0,0,0,1,101,0,0,0,52
0,0,0,1,101,0,0,0,64
0,0,0,1,101,0,0,0,60
0,0,0,1,101,0,0,0,61
0,0,0,1,101,0,0,0,56
0,0,0,1,101,0,0,0,59
0,0,0,1,101,0,0,0,53
0,0,0,1,101,0,0,0,48
0,0,0,1,101,0,0,0,123
0,0,0,1,101,0,0,0,121
0,0,0,1,101,0,0,0,55
0,0,0,1,101,0,0,0,131
0,0,0,1,101,0,0,0,41
0,0,0,1,101,0,0,0,227
0,0,0,1,101,0,0,0,106
0,0,0,1,101,0,0,0,44
0,0,0,1,101,0,0,0,241
0,0,0,1,101,0,0,0,814
0,0,0,1,101,0,0,0,83
0,0,0,1,101,0,0,0,459
0,0,0,1,101,0,0,0,41
0,0,0,1,101,0,0,0,280
0,0,0,1,101,0,0,0,207
0,0,0,1,101,0,0,0,146
0,0,0,1,101,0,0,0,83
0,0,0,1,101,0,0,0,298
0,0,0,1,101,0,0,0,23
0,0,0,1,101,0,0,0,244
0,0,0,1,101,0,0,0,462
0,0,0,1,101,0,0,0,110
0,0,0,1,101,0,0,0,551
0,0,0,1,101,0,0,0,1253
0,0,0,1,101,0,0,0,112
0,0,0,1,101,0,0,0,61
0,0,0,1,101,0,0,0,2282
0,0,0,1,101,0,0,0,179
0,0,0,1,101,0,0,0,1413
0,0,0,1,101,0,0,0,247
0,0,0,1,101,0,0,0,63
0,0,0,1,101,0,0,0,212
0,0,0,1,101,0,0,0,45
0,0,0,1,101,0,0,0,301
0,0,0,1,101,0,0,0,43
0,0,0,1,101,0,0,0,18
0,0,0,1,101,0,0,0,36
0,0,0,1,101,0,0,0,219
0,0,0,1,101,0,0,0,32
0,0,0,1,101,0,0,0,466
0,0,0,1,101,0,0,0,248
0,0,0,1,101,0,0,0,3299
0,0,0,1,101,0,0,0,45
0,0,0,1,101,0,0,0,93
0,0,0,1,101,0,0,0,65
0,0,0,1,101,0,0,0,33
0,0,0,1,101,0,0,0,48
0,0,0,1,101,0,0,0,168
0,0,0,1,101,0,0,0,74
0,0,0,1,101,0,0,0,38
0,0,0,1,101,0,0,0,24
0,0,0,1,101,0,0,0,110
0,0,0,1,101,0,0,0,46
0,0,0,1,101,0,0,0,104
0,0,0,1,101,0,0,0,126
0,0,0,1,101,0,0,0,76
0,0,0,1,101,0,0,0,45
0,0,0,1,101,0,0,0,41
0,0,0,1,101,0,0,0,84
0,0,0,1,101,0,0,0,52
0,0,0,1,101,0,0,0,95
0,0,0,1,101,0,0,0,79
0,0,0,1,101,0,0,0,196
0,0,0,1,101,0,0,0,537
0,0,0,1,101,0,0,0,376
0,0,0,1,101,0,0,0,201
0,0,0,1,101,0,0,0,177
0,0,0,1,101,0,0,0,18
0,0,0,1,101,0,0,0,141
0,0,0,1,101,0,0,0,128
0,0,0,1,101,0,0,0,110
0,0,0,1,101,0,0,0,343
0,0,0,1,101,0,0,0,850
0,0,0,1,101,0,0,0,267
0,0,0,1,101,0,0,0,101
0,0,0,1,101,0,0,0,970
0,0,0,1,101,0,0,0,54
0,0,0,1,101,0,0,0,370
0,0,0,1,101,0,0,0,1064
0,0,0,1,101,0,0,0,421
0,0,0,1,101,0,0,0,153
0,0,0,1,101,0,0,0,96
0,0,0,1,101,0,0,0,91
0,0,0,1,101,0,0,0,153
0,0,0,1,101,0,0,0,71
0,0,0,1,101,0,0,0,4056
0,0,0,1,101,0,0,0,421
0,0,0,1,101,0,0,0,99
0,0,0,1,101,0,0,0,41
0,0,0,1,101,0,0,0,197
0,0,0,1,101,0,0,0,118
0,0,0,1,101,0,0,0,110
0,0,0,1,101,0,0,0,176
0,0,0,1,101,0,0,0,264
0,0,0,1,101,0,0,0,146
0,0,0,1,101,0,0,0,242
0,0,0,1,101,0,0,0,900
0,0,0,1,101,0,0,0,109
0,0,0,1,101,0,0,0,606
0,0,0,1,101,0,0,0,421
0,0,0,1,101,0,0,0,302
0,0,0,1,101,0,0,0,165
0,0,0,1,101,0,0,0,74
0,0,0,1,101,0,0,0,393
0,0,0,1,101,0,0,0,118
0,0,0,1,101,0,0,0,155
0,0,0,1,101,0,0,0,89
0,0,0,1,101,0,0,0,290
0,0,0,1,101,0,0,0,224
0,0,0,1,101,0,0,0,309
0,0,0,1,101,0,0,0,275
0,0,0,1,101,0,0,0,56
0,0,0,1,101,0,0,0,41
0,0,0,1,101,0,0,0,33
0,0,0,1,101,0,0,0,140
0,0,0,1,101,0,0,0,23
0,0,0,1,101,0,0,0,333
0,0,0,1,101,0,0,0,127
0,0,0,1,101,0,0,0,301
0,0,0,1,101,0,0,0,1069
0,0,0,1,101,0,0,0,86
0,0,0,1,101,0,0,0,87
0,0,0,1,101,0,0,0,50
0,0,0,1,101,0,0,0,178
0,0,0,1,101,0,0,0,137
0,0,0,1,101,0,0,0,42
0,0,0,1,101,0,0,0,124
0,0,0,1,101,0,0,0,303
0,0,0,1,101,0,0,0,95
0,0,0,1,101,0,0,0,392
0,0,0,1,101,0,0,0,83
0,0,0,1,101,0,0,0,111
0,0,0,1,101,0,0,0,72
0,0,0,1,101,0,0,0,119
0,0,0,1,101,0,0,0,140
0,0,0,1,101,0,0,0,123
0,0,0,1,101,0,0,0,257
0,0,0,1,101,0,0,0,87
0,0,0,1,101,0,0,0,158
0,0,0,1,101,0,0,0,301
0,0,0,1,101,0,0,0,89
0,0,0,1,101,0,0,0,272
0,0,0,1,101,0,0,0,80
0,0,0,1,101,0,0,0,204
0,0,0,1,101,0,0,0,71
0,0,0,1,101,0,0,0,304
0,0,0,1,101,0,0,0,161
0,0,0,1,101,0,0,0,227
0,0,0,1,101,0,0,0,113
0,0,0,1,101,0,0,0,76
0,0,0,1,101,0,0,0,26
0,0,0,1,101,0,0,0,2626
0,0,0,1,101,0,0,0,249
0,0,0,1,101,0,0,0,335
0,0,0,1,101,0,0,0,116
0,0,0,1,101,0,0,0,181
0,0,0,1,101,0,0,0,106
0,0,0,1,101,0,0,0,134
0,0,0,1,101,0,0,0,63
0,0,0,1,101,0,0,0,80
0,0,0,1,101,0,0,0,133
0,0,0,1,101,0,0,0,228
0,0,0,1,101,0,0,0,291
0,0,0,1,101,0,0,0,156
0,0,0,1,101,0,0,0,54
0,0,0,1,101,0,0,0,261
0,0,0,1,101,0,0,0,41
0,0,0,1,101,0,0,0,160
0,0,0,1,101,0,0,0,61
0,0,0,1,101,0,0,0,79
0,0,0,1,101,0,0,0,51
0,0,0,1,101,0,0,0,112
0,0,0,1,101,0,0,0,68
0,0,0,1,101,0,0,0,865
0,0,0,1,101,0,0,0,806
0,0,0,1,101,0,0,0,46
0,0,0,1,101,0,0,0,257
0,0,0,1,101,0,0,0,165
0,0,0,1,101,0,0,0,169
0,0,0,1,101,0,0,0,82
0,0,0,1,101,0,0,0,268
0,0,0,1,101,0,0,0,53
0,0,0,1,101,0,0,0,357
0,0,0,1,101,0,0,0,92
0,0,0,1,101,0,0,0,413
0,0,0,1,101,0,0,0,274
0,0,0,1,101,0,0,0,76
0,0,0,1,101,0,0,0,62
0,0,0,1,101,0,0,0,69
0,0,0,1,101,0,0,0,116
0,0,0,1,101,0,0,0,359
0,0,0,1,101,0,0,0,116
0,0,0,1,101,0,0,0,386
0,0,0,1,101,0,0,0,169
0,0,0,1,101,0,0,0,820
0,0,0,1,101,0,0,0,114
0,0,0,1,101,0,0,0,245
0,0,0,1,101,0,0,0,779
0,0,0,1,101,0,0,0,22
0,0,0,1,101,0,0,0,15
0,0,0,1,101,0,0,0,153
0,0,0,1,101,0,0,0,87
0,0,0,1,101,0,0,0,92
0,0,0,1,101,0,0,0,151
0,0,0,1,101,0,0,0,47
0,0,0,1,101,0,0,0,147
0,0,0,1,101,0,0,0,56
0,0,0,1,101,0,0,0,108
0,0,0,1,101,0,0,0,54
0,0,0,1,101,0,0,0,67
0,0,0,1,101,0,0,0,62
0,0,0,1,101,0,0,0,31
0,0,0,1,101,0,0,0,118
0,0,0,1,101,0,0,0,133
0,0,0,1,101,0,0,0,65
0,0,0,1,101,0,0,0,80
0,0,0,1,101,0,0,0,50
0,0,0,1,101,0,0,0,50
0,0,0,1,101,0,0,0,157
0,0,0,1,101,0,0,0,104
0,0,0,1,101,0,0,0,60
0,0,0,1,101,0,0,0,81
0,0,0,1,101,0,0,0,27
0,0,0,1,101,0,0,0,128
0,0,0,1,101,0,0,0,204
0,0,0,1,101,0,0,0,53
0,0,0,1,101,0,0,0,166
0,0,0,1,101,0,0,0,59
0,0,0,1,101,0,0,0,34
0,0,0,1,101,0,0,0,56
0,0,0,1,101,0,0,0,54
0,0,0,1,101,0,0,0,114
0,0,0,1,101,0,0,0,99
0,0,0,1,101,0,0,0,300
0,0,0,1,101,0,0,0,51
0,0,0,1,101,0,0,0,40
0,0,0,1,101,0,0,0,143
0,0,0,1,101,0,0,0,73
0,0,0,1,101,0,0,0,25
0,0,0,1,101,0,0,0,201
0,0,0,1,101,0,0,0,118
0,0,0,1,101,0,0,0,51
0,0,0,1,101,0,0,0,63
0,0,0,1,101,0,0,0,85
0,0,0,1,101,0,0,0,87
0,0,0,1,101,0,0,0,108
0,0,0,1,101,0,0,0,350
0,0,0,1,101,0,0,0,53
0,0,0,1,101,0,0,0,59
0,0,0,1,101,0,0,0,77
0,0,0,1,101,0,0,0,75
0,0,0,1,101,0,0,0,139
0,0,0,1,101,0,0,0,154
0,0,0,1,101,0,0,0,107
0,0,0,1,101,0,0,0,63
0,0,0,1,101,0,0,0,63
0,0,0,1,101,0,0,0,51
0,0,0,1,101,0,0,0,144
0,0,0,1,101,0,0,0,65
0,0,0,1,101,0,0,0,54
0,0,0,1,101,0,0,0,354
0,0,0,1,101,0,0,0,116
0,0,0,1,101,0,0,0,33
0,0,0,1,101,0,0,0,45
0,0,0,1,101,0,0,0,39
0,0,0,1,101,0,0,0,36
0,0,0,1,101,0,0,0,35
0,0,0,1,101,0,0,0,36
0,0,0,1,101,0,0,0,38
0,0,0,1,101,0,0,0,158
0,0,0,1,101,0,0,0,62
0,0,0,1,101,0,0,0,137
0,0,0,1,101,0,0,0,67
0,0,0,1,101,0,0,0,78
0,0,0,1,101,0,0,0,84
0,0,0,1,101,0,0,0,70
0,0,0,1,101,0,0,0,187
0,0,0,1,101,0,0,0,59
0,0,0,1,101,0,0,0,58
0,0,0,1,101,0,0,0,49
0,0,0,1,101,0,0,0,64
0,0,0,1,101,0,0,0,34
0,0,0,1,101,0,0,0,225
0,0,0,1,101,0,0,0,73
0,0,0,1,101,0,0,0,148
0,0,0,1,101,0,0,0,102
0,0,0,1,101,0,0,0,63
0,0,0,1,101,0,0,0,160
0,0,0,1,101,0,0,0,76
0,0,0,1,101,0,0,0,394
0,0,0,1,101,0,0,0,15
0,0,0,1,101,0,0,0,76
0,0,0,1,101,0,0,0,153
0,0,0,1,101,0,0,0,73
0,0,0,1,101,0,0,0,66
0,0,0,1,101,0,0,0,68
0,0,0,1,101,0,0,0,66
0,0,0,1,101,0,0,0,60
0,0,0,1,101,0,0,0,112
0,0,0,1,101,0,0,0,78
0,0,0,1,101,0,0,0,53
0,0,0,1,101,0,0,0,70
0,0,0,1,101,0,0,0,189
0,0,0,1,101,0,0,0,105
0,0,0,1,101,0,0,0,63
0,0,0,1,101,0,0,0,75
0,0,0,1,101,0,0,0,27
0,0,0,1,101,0,0,0,85
0,0,0,1,101,0,0,0,65
0,0,0,1,101,0,0,0,162
0,0,0,1,101,0,0,0,69
0,0,0,1,101,0,0,0,39
0,0,0,1,101,0,0,0,65
0,0,0,1,101,0,0,0,130
0,0,0,1,101,0,0,0,69
0,0,0,1,101,0,0,0,129
0,0,0,1,101,0,0,0,51
0,0,0,1,101,0,0,0,109
0,0,0,1,101,0,0,0,81
0,0,0,1,101,0,0,0,109
0,0,0,1,101,0,0,0,138
0,0,0,1,101,0,0,0,148
0,0,0,1,101,0,0,0,99
0,0,0,1,101,0,0,0,78
0,0,0,1,101,0,0,0,66
0,0,0,1,101,0,0,0,51
0,0,0,1,101,0,0,0,150
0,0,0,1,101,0,0,0,79
0,0,0,1,101,0,0,0,54
0,0,0,1,101,0,0,0,96
0,0,0,1,101,0,0,0,34
0,0,0,1,101,0,0,0,136
0,0,0,1,101,0,0,0,67
0,0,0,1,101,0,0,0,126
0,0,0,1,101,0,0,0,85
0,0,0,1,101,0,0,0,57
0,0,0,1,101,0,0,0,74
0,0,0,1,101,0,0,0,65
0,0,0,1,101,0,0,0,87
0,0,0,1,101,0,0,0,59
0,0,0,1,101,0,0,0,52
0,0,0,1,101,0,0,0,49
0,0,0,1,101,0,0,0,56
0,0,0,1,101,0,0,0,201
0,0,0,1,101,0,0,0,143
0,0,0,1,101,0,0,0,100
0,0,0,1,101,0,0,0,58
0,0,0,1,101,0,0,0,130
0,0,0,1,101,0,0,0,406
0,0,0,1,101,0,0,0,147
0,0,0,1,101,0,0,0,272
0,0,0,1,101,0,0,0,313
0,0,0,1,101,0,0,0,755
0,0,0,1,101,0,0,0,162
0,0,0,1,101,0,0,0,277
0,0,0,1,101,0,0,0,467
0,0,0,1,101,0,0,0,48
0,0,0,1,101,0,0,0,106
0,0,0,1,101,0,0,0,20
0,0,0,1,101,0,0,0,22
0,0,0,1,101,0,0,0,63
0,0,0,1,101,0,0,0,157
0,0,0,1,101,0,0,0,223
0,0,0,1,101,0,0,0,90
0,0,0,1,101,0,0,0,155
0,0,0,1,101,0,0,0,305
0,0,0,1,101,0,0,0,692
0,0,0,1,101,0,0,0,104
0,0,0,1,101,0,0,0,82
0,0,0,1,101,0,0,0,305
0,0,0,1,101,0,0,0,58
0,0,0,1,101,0,0,0,177
0,0,0,1,101,0,0,0,649
0,0,0,1,101,0,0,0,320
0,0,0,1,101,0,0,0,84
0,0,0,1,101,0,0,0,53
0,0,0,1,101,0,0,0,241
0,0,0,1,101,0,0,0,298
0,0,0,1,101,0,0,0,324
0,0,0,1,101,0,0,0,146
0,0,0,1,101,0,0,0,77
0,0,0,1,101,0,0,0,116
0,0,0,1,101,0,0,0,81
0,0,0,1,101,0,0,0,160
0,0,0,1,101,0,0,0,629
0,0,0,1,101,0,0,0,51
0,0,0,1,101,0,0,0,44
0,0,0,1,101,0,0,0,50
0,0,0,1,101,0,0,0,59
0,0,0,1,101,0,0,0,47
0,0,0,1,101,0,0,0,65
0,0,0,1,101,0,0,0,49
0,0,0,1,101,0,0,0,47
0,0,0,1,101,0,0,0,50
0,0,0,1,101,0,0,0,45
0,0,0,1,101,0,0,0,68
0,0,0,1,101,0,0,0,111
0,0,0,1,101,0,0,0,367
0,0,0,1,101,0,0,0,26
0,0,0,1,101,0,0,0,30
0,0,0,1,101,0,0,0,45
0,0,0,1,101,0,0,0,264
0,0,0,1,101,0,0,0,38
0,0,0,1,101,0,0,0,94
0,0,0,1,101,0,0,0,282
0,0,0,1,101,0,0,0,191
0,0,0,1,101,0,0,0,18
0,0,0,1,101,0,0,0,32
0,0,0,1,101,0,0,0,1301
0,0,0,1,101,0,0,0,500
0,0,0,1,101,0,0,0,138
0,0,0,1,101,0,0,0,157
0,0,0,1,101,0,0,0,110
0,0,0,1,101,0,0,0,36
0,0,0,1,101,0,0,0,1583
0,0,0,1,101,0,0,0,1080
0,0,0,1,101,0,0,0,155
0,0,0,1,101,0,0,0,235
0,0,0,1,101,0,0,0,364
0,0,0,1,101,0,0,0,404
0,0,0,1,101,0,0,0,54
0,0,0,1,101,0,0,0,371
0,0,0,1,101,0,0,0,54
0,0,0,1,101,0,0,0,588
0,0,0,1,101,0,0,0,214
0,0,0,1,101,0,0,0,39
0,0,0,1,101,0,0,0,73
0,0,0,1,101,0,0,0,17
0,0,0,1,101,0,0,0,45
0,0,0,1,101,0,0,0,88
0,0,0,1,101,0,0,0,62
0,0,0,1,101,0,0,0,57
0,0,0,1,101,0,0,0,92
0,0,0,1,101,0,0,0,70
0,0,0,1,101,0,0,0,103
0,0,0,1,101,0,0,0,77
0,0,0,1,101,0,0,0,45
0,0,0,1,101,0,0,0,214
0,0,0,1,101,0,0,0,71
0,0,0,1,101,0,0,0,59
0,0,0,1,101,0,0,0,42
0,0,0,1,101,0,0,0,120
0,0,0,1,101,0,0,0,49
0,0,0,1,101,0,0,0,79
0,0,0,1,101,0,0,0,39
0,0,0,1,101,0,0,0,58
0,0,0,1,101,0,0,0,75
0,0,0,1,101,0,0,0,103
0,0,0,1,101,0,0,0,81
0,0,0,1,101,0,0,0,151
0,0,0,1,101,0,0,0,519
0,0,0,1,101,0,0,0,43
0,0,0,1,101,0,0,0,120
0,0,0,1,101,0,0,0,40
0,0,0,1,101,0,0,0,94
0,0,0,1,101,0,0,0,59
0,0,0,1,101,0,0,0,57
0,0,0,1,101,0,0,0,57
0,0,0,1,101,0,0,0,62
0,0,0,1,101,0,0,0,77
0,0,0,1,101,0,0,0,16
0,0,0,1,101,0,0,0,125
0,0,0,1,101,0,0,0,81
0,0,0,1,101,0,0,0,76
0,0,0,1,101,0,0,0,125
0,0,0,1,101,0,0,0,75
0,0,0,1,101,0,0,0,40
0,0,0,1,101,0,0,0,71
0,0,0,1,101,0,0,0,64
0,0,0,1,101,0,0,0,24
0,0,0,1,101,0,0,0,44
0,0,0,1,101,0,0,0,62
0,0,0,1,101,0,0,0,182
0,0,0,1,101,0,0,0,45
0,0,0,1,101,0,0,0,32
0,0,0,1,101,0,0,0,42
0,0,0,1,101,0,0,0,89
0,0,0,1,101,0,0,0,172
0,0,0,1,101,0,0,0,42
0,0,0,1,101,0,0,0,150
0,0,0,1,101,0,0,0,129
0,0,0,1,101,0,0,0,58
0,0,0,1,101,0,0,0,62
0,0,0,1,101,0,0,0,105
0,0,0,1,101,0,0,0,175
0,0,0,1,101,0,0,0,68
0,0,0,1,101,0,0,0,42
0,0,0,1,101,0,0,0,44
0,0,0,1,101,0,0,0,36
0,0,0,1,101,0,0,0,52
0,0,0,1,101,0,0,0,223
0,0,0,1,101,0,0,0,37
0,0,0,1,101,0,0,0,135
0,0,0,1,101,0,0,0,62
0,0,0,1,101,0,0,0,62
0,0,0,1,101,0,0,0,1355
0,0,0,1,101,0,0,0,79
0,0,0,1,101,0,0,0,76
0,0,0,1,101,0,0,0,79
0,0,0,1,101,0,0,0,59
0,0,0,1,101,0,0,0,64
0,0,0,1,101,0,0,0,115
0,0,0,1,101,0,0,0,60
0,0,0,1,101,0,0,0,54
0,0,0,1,101,0,0,0,83
0,0,0,1,101,0,0,0,83
0,0,0,1,101,0,0,0,333
0,0,0,1,101,0,0,0,154
0,0,0,1,101,0,0,0,146
0,0,0,1,101,0,0,0,36
0,0,0,1,101,0,0,0,111
0,0,0,1,101,0,0,0,351
0,0,0,1,101,0,0,0,186
0,0,0,1,101,0,0,0,169
0,0,0,1,101,0,0,0,110
0,0,0,1,101,0,0,0,46
0,0,0,1,101,0,0,0,206
0,0,0,1,101,0,0,0,69
0,0,0,1,101,0,0,0,59
0,0,0,1,101,0,0,0,299
0,0,0,1,101,0,0,0,71
0,0,0,1,101,0,0,0,136
0,0,0,1,101,0,0,0,62
0,0,0,1,101,0,0,0,100
0,0,0,1,101,0,0,0,99
0,0,0,1,101,0,0,0,64
0,0,0,1,101,0,0,0,91
0,0,0,1,101,0,0,0,89
0,0,0,1,101,0,0,0,421
0,0,0,1,101,0,0,0,165
0,0,0,1,101,0,0,0,90
0,0,0,1,101,0,0,0,76
0,0,0,1,101,0,0,0,73
0,0,0,1,101,0,0,0,113
0,0,0,1,101,0,0,0,166
0,0,0,1,101,0,0,0,133
0,0,0,1,101,0,0,0,120
0,0,0,1,101,0,0,0,43
0,0,0,1,101,0,0,0,49
0,0,0,1,101,0,0,0,74
0,0,0,1,101,0,0,0,367
0,0,0,1,101,0,0,0,115
0,0,0,1,101,0,0,0,45
0,0,0,1,101,0,0,0,83
0,0,0,1,101,0,0,0,34
0,0,0,1,101,0,0,0,138
0,0,0,1,101,0,0,0,228
0,0,0,1,101,0,0,0,143
0,0,0,1,101,0,0,0,255
0,0,0,1,101,0,0,0,35
0,0,0,1,101,0,0,0,274
0,0,0,1,101,0,0,0,187
0,0,0,1,101,0,0,0,119
0,0,0,1,101,0,0,0,62
0,0,0,1,101,0,0,0,69
0,0,0,1,101,0,0,0,171
0,0,0,1,101,0,0,0,46
0,0,0,1,101,0,0,0,172
0,0,0,1,101,0,0,0,32
0,0,0,1,101,0,0,0,78
0,0,0,1,101,0,0,0,127
0,0,0,1,101,0,0,0,198
0,0,0,1,101,0,0,0,43
0,0,0,1,101,0,0,0,159
0,0,0,1,101,0,0,0,133
0,0,0,1,101,0,0,0,129
0,0,0,1,101,0,0,0,90
0,0,0,1,101,0,0,0,56
0,0,0,1,101,0,0,0,465
0,0,0,1,101,0,0,0,95
0,0,0,1,101,0,0,0,206
0,0,0,1,101,0,0,0,106
0,0,0,1,101,0,0,0,92
0,0,0,1,101,0,0,0,27
0,0,0,1,101,0,0,0,208
0,0,0,1,101,0,0,0,475
0,0,0,1,101,0,0,0,269
0,0,0,1,101,0,0,0,259
0,0,0,1,101,0,0,0,156
0,0,0,1,101,0,0,0,190
0,0,0,1,101,0,0,0,235
0,0,0,1,101,0,0,0,116
0,0,0,1,101,0,0,0,52
0,0,0,1,101,0,0,0,534
0,0,0,1,101,0,0,0,66
0,0,0,1,101,0,0,0,23
0,0,0,1,101,0,0,0,65
0,0,0,1,101,0,0,0,254
0,0,0,1,101,0,0,0,74
0,0,0,1,101,0,0,0,68
0,0,0,1,101,0,0,0,262
0,0,0,1,101,0,0,0,102
0,0,0,1,101,0,0,0,75
0,0,0,1,101,0,0,0,79
0,0,0,1,101,0,0,0,146
0,0,0,1,101,0,0,0,79
0,0,0,1,101,0,0,0,75
0,0,0,1,101,0,0,0,253
0,0,0,1,101,0,0,0,90
0,0,0,1,101,0,0,0,29
0,0,0,1,101,0,0,0,51
0,0,0,1,101,0,0,0,79
0,0,0,1,101,0,0,0,45
0,0,0,1,101,0,0,0,124
0,0,0,1,101,0,0,0,65
0,0,0,1,101,0,0,0,1051
0,0,0,1,101,0,0,0,65
0,0,0,1,101,0,0,0,31
0,0,0,1,101,0,0,0,148
0,0,0,1,101,0,0,0,255
0,0,0,1,101,0,0,0,49
0,0,0,1,101,0,0,0,67
0,0,0,1,101,0,0,0,37
0,0,0,1,101,0,0,0,183
0,0,0,1,101,0,0,0,71
0,0,0,1,101,0,0,0,15
0,0,0,1,101,0,0,0,115
0,0,0,1,101,0,0,0,104
0,0,0,1,101,0,0,0,252
0,0,0,1,101,0,0,0,75
0,0,0,1,101,0,0,0,74
8,4,4,2,87,0,0,0,525
0,0,0,1,101,0,0,0,157
0,0,0,1,101,0,0,0,136
0,0,0,1,101,0,0,0,52
0,0,0,1,101,0,0,0,75
0,0,0,1,101,0,0,0,159
0,0,0,1,101,0,0,0,105
0,0,0,1,101,0,0,0,93
0,0,0,1,101,0,0,0,73
0,0,0,1,101,0,0,0,52
0,0,0,1,101,0,0,0,58
0,0,0,1,101,0,0,0,109
0,0,0,1,101,0,0,0,93
0,0,0,1,101,0,0,0,219
0,0,0,1,101,0,0,0,71
0,0,0,1,101,0,0,0,274
0,0,0,1,101,0,0,0,94
0,0,0,1,101,0,0,0,128
0,0,0,1,101,0,0,0,117
0,0,0,1,101,0,0,0,182
0,0,0,1,101,0,0,0,95
0,0,0,1,101,0,0,0,219
0,0,0,1,101,0,0,0,344
0,0,0,1,101,0,0,0,230
0,0,0,1,101,0,0,0,169
0,0,0,1,101,0,0,0,91
0,0,0,1,101,0,0,0,151
0,0,0,1,101,0,0,0,141
0,0,0,1,101,0,0,0,58
0,0,0,1,101,0,0,0,54
0,0,0,1,101,0,0,0,140
0,0,0,1,101,0,0,0,20
0,0,0,1,101,0,0,0,27
0,0,0,1,101,0,0,0,1451
0,0,0,1,101,0,0,0,170
0,0,0,1,101,0,0,0,236
0,0,0,1,101,0,0,0,53
0,0,0,1,101,0,0,0,654
0,0,0,1,101,0,0,0,490
0,0,0,1,101,0,0,0,51
0,0,0,1,101,0,0,0,28
0,0,0,1,101,0,0,0,32
0,0,0,1,101,0,0,0,95
0,0,0,1,101,0,0,0,116
0,0,0,1,101,0,0,0,171
0,0,0,1,101,0,0,0,26
0,0,0,1,101,0,0,0,155
0,0,0,1,101,0,0,0,159
0,0,0,1,101,0,0,0,23
0,0,0,1,101,0,0,0,709
0,0,0,1,101,0,0,0,393
0,0,0,1,101,0,0,0,58
0,0,0,1,101,0,0,0,122
0,0,0,1,101,0,0,0,36
0,0,0,1,101,0,0,0,69
0,0,0,1,101,0,0,0,372
0,0,0,1,101,0,0,0,89
0,0,0,1,101,0,0,0,69
0,0,0,1,101,0,0,0,96
0,0,0,1,101,0,0,0,117
0,0,0,1,101,0,0,0,89
0,0,0,1,101,0,0,0,48
0,0,0,1,101,0,0,0,135
0,0,0,1,101,0,0,0,96
0,0,0,1,101,0,0,0,75
0,0,0,1,101,0,0,0,134
0,0,0,1,101,0,0,0,130
0,0,0,1,101,0,0,0,60
0,0,0,1,101,0,0,0,51
0,0,0,1,101,0,0,0,39
0,0,0,1,101,0,0,0,85
0,0,0,1,101,0,0,0,408
0,0,0,1,101,0,0,0,103
0,0,0,1,101,0,0,0,44
0,0,0,1,101,0,0,0,73
0,0,0,1,101,0,0,0,34
0,0,0,1,101,0,0,0,120
0,0,0,1,101,0,0,0,34
0,0,0,1,101,0,0,0,99
0,0,0,1,101,0,0,0,42
0,0,0,1,101,0,0,0,143
0,0,0,1,101,0,0,0,60
0,0,0,1,101,0,0,0,222
0,0,0,1,101,0,0,0,78
0,0,0,1,101,0,0,0,252
0,0,0,1,101,0,0,0,56
0,0,0,1,101,0,0,0,92
0,0,0,1,101,0,0,0,121
0,0,0,1,101,0,0,0,89
0,0,0,1,101,0,0,0,166
0,0,0,1,101,0,0,0,540
0,0,0,1,101,0,0,0,198
0,0,0,1,101,0,0,0,292
0,0,0,1,101,0,0,0,172
0,0,0,1,101,0,0,0,209
0,0,0,1,101,0,0,0,108
0,0,0,1,101,0,0,0,41
0,0,0,1,101,0,0,0,35
0,0,0,1,101,0,0,0,208
0,0,0,1,101,0,0,0,29
0,0,0,1,101,0,0,0,75
0,0,0,1,101,0,0,0,106
0,0,0,1,101,0,0,0,41
0,0,0,1,101,0,0,0,287
0,0,0,1,101,0,0,0,58
0,0,0,1,101,0,0,0,53
0,0,0,1,101,0,0,0,58
0,0,0,1,101,0,0,0,421
0,0,0,1,101,0,0,0,39
0,0,0,1,101,0,0,0,194
0,0,0,1,101,0,0,0,81
0,0,0,1,101,0,0,0,116
0,0,0,1,101,0,0,0,99
0,0,0,1,101,0,0,0,1363
0,0,0,1,101,0,0,0,156
0,0,0,1,101,0,0,0,46
0,0,0,1,101,0,0,0,80
0,0,0,1,101,0,0,0,128
0,0,0,1,101,0,0,0,83
0,0,0,1,101,0,0,0,66
0,0,0,1,101,0,0,0,86
0,0,0,1,101,0,0,0,78
0,0,0,1,101,0,0,0,47
0,0,0,1,101,0,0,0,198
0,0,0,1,101,0,0,0,68
0,0,0,1,101,0,0,0,60
0,0,0,1,101,0,0,0,118
0,0,0,1,101,0,0,0,225
0,0,0,1,101,0,0,0,55
0,0,0,1,101,0,0,0,177
0,0,0,1,101,0,0,0,633
0,0,0,1,101,0,0,0,571
0,0,0,1,101,0,0,0,51
0,0,0,1,101,0,0,0,36
0,0,0,1,101,0,0,0,144
0,0,0,1,101,0,0,0,193
0,0,0,1,101,0,0,0,49
0,0,0,1,101,0,0,0,58
0,0,0,1,101,0,0,0,120
0,0,0,1,101,0,0,0,60
0,0,0,1,101,0,0,0,476
0,0,0,1,101,0,0,0,71
0,0,0,1,101,0,0,0,34
0,0,0,1,101,0,0,0,118
0,0,0,1,101,0,0,0,1080
0,0,0,1,101,0,0,0,53
0,0,0,1,101,0,0,0,58
0,0,0,1,101,0,0,0,93
0,0,0,1,101,0,0,0,33
0,0,0,1,101,0,0,0,100
0,0,0,1,101,0,0,0,65
0,0,0,1,101,0,0,0,44
0,0,0,1,101,0,0,0,83
0,0,0,1,101,0,0,0,94
0,0,0,1,101,0,0,0,107
0,0,0,1,101,0,0,0,101
0,0,0,1,101,0,0,0,68
0,0,0,1,101,0,0,0,61
0,0,0,1,101,0,0,0,512
0,0,0,1,101,0,0,0,30
0,0,0,1,101,0,0,0,417
0,0,0,1,101,0,0,0,56
0,0,0,1,101,0,0,0,101
0,0,0,1,101,0,0,0,42
0,0,0,1,101,0,0,0,1
0,0,0,1,101,0,0,0,198
0,0,0,1,101,0,0,0,152
0,0,0,1,101,0,0,0,52
0,0,0,1,101,0,0,0,97
0,0,0,1,101,0,0,0,401
0,0,0,1,101,0,0,0,101
0,0,0,1,101,0,0,0,88
0,0,0,1,101,0,0,0,110
0,0,0,1,101,0,0,0,116
0,0,0,1,101,0,0,0,93
0,0,0,1,101,0,0,0,119
0,0,0,1,101,0,0,0,847
0,0,0,1,101,0,0,0,338
0,0,0,1,101,0,0,0,33
0,0,0,1,101,0,0,0,67
0,0,0,1,101,0,0,0,53
0,0,0,1,101,0,0,0,69
0,0,0,1,101,0,0,0,37
0,0,0,1,101,0,0,0,94
0,0,0,1,101,0,0,0,295
0,0,0,1,101,0,0,0,15
0,0,0,1,101,0,0,0,72
0,0,0,1,101,0,0,0,46
0,0,0,1,101,0,0,0,52
0,0,0,1,101,0,0,0,35
0,0,0,1,101,0,0,0,98
0,0,0,1,101,0,0,0,39
0,0,0,1,101,0,0,0,109
0,0,0,1,101,0,0,0,109
0,0,0,1,101,0,0,0,207
0,0,0,1,101,0,0,0,117
0,0,0,1,101,0,0,0,41
0,0,0,1,101,0,0,0,58
0,0,0,1,101,0,0,0,180
0,0,0,1,101,0,0,0,173
0,0,0,1,101,0,0,0,124
0,0,0,1,101,0,0,0,56
0,0,0,1,101,0,0,0,163
0,0,0,1,101,0,0,0,49
0,0,0,1,101,0,0,0,95
0,0,0,1,101,0,0,0,60
0,0,0,1,101,0,0,0,338
0,0,0,1,101,0,0,0,217
0,0,0,1,101,0,0,0,102
0,0,0,1,101,0,0,0,91
0,0,0,1,101,0,0,0,175
0,0,0,1,101,0,0,0,427
0,0,0,1,101,0,0,0,154
0,0,0,1,101,0,0,0,188
0,0,0,1,101,0,0,0,84
0,0,0,1,101,0,0,0,178
0,0,0,1,101,0,0,0,1
0,0,0,1,101,0,0,0,42
0,0,0,1,101,0,0,0,48
0,0,0,1,101,0,0,0,141
0,0,0,1,101,0,0,0,145
0,0,0,1,101,0,0,0,41
0,0,0,1,101,0,0,0,77
0,0,0,1,101,0,0,0,39
0,0,0,1,101,0,0,0,287
0,0,0,1,101,0,0,0,37
0,0,0,1,101,0,0,0,112
0,0,0,1,101,0,0,0,60
0,0,0,1,101,0,0,0,18
0,0,0,1,101,0,0,0,13
0,0,0,1,101,0,0,0,5
0,0,0,1,101,0,0,0,11
0,0,0,1,101,0,0,0,107
0,0,0,1,101,0,0,0,94
0,0,0,1,101,0,0,0,8
0,0,0,1,101,0,0,0,64
0,0,0,1,101,0,0,0,1399
0,0,0,1,101,0,0,0,110
0,0,0,1,101,0,0,0,84
0,0,0,1,101,0,0,0,77
0,0,0,1,101,0,0,0,195
0,0,0,1,101,0,0,0,84
0,0,0,1,101,0,0,0,6
0,0,0,1,101,0,0,0,55
0,0,0,1,101,0,0,0,57
0,0,0,1,101,0,0,0,54
0,0,0,1,101,0,0,0,43
0,0,0,1,101,0,0,0,49
0,0,0,1,101,0,0,0,159
0,0,0,1,101,0,0,0,102
0,0,0,1,101,0,0,0,107
0,0,0,1,101,0,0,0,121
0,0,0,1,101,0,0,0,58
0,0,0,1,101,0,0,0,97
0,0,0,1,101,0,0,0,291
0,0,0,1,101,0,0,0,3
0,0,0,1,101,0,0,0,377
0,0,0,1,101,0,0,0,97
0,0,0,1,101,0,0,0,145
0,0,0,1,101,0,0,0,49
0,0,0,1,101,0,0,0,94
0,0,0,1,101,0,0,0,46
0,0,0,1,101,0,0,0,107
0,0,0,1,101,0,0,0,43
0,0,0,1,101,0,0,0,57
0,0,0,1,101,0,0,0,258
0,0,0,1,101,0,0,0,59
0,0,0,1,101,0,0,0,64
0,0,0,1,101,0,0,0,71
0,0,0,1,101,0,0,0,64
0,0,0,1,101,0,0,0,63
0,0,0,1,101,0,0,0,94
0,0,0,1,101,0,0,0,340
0,0,0,1,101,0,0,0,112
0,0,0,1,101,0,0,0,95
0,0,0,1,101,0,0,0,42
0,0,0,1,101,0,0,0,118
0,0,0,1,101,0,0,0,155
0,0,0,1,101,0,0,0,48
0,0,0,1,101,0,0,0,72
0,0,0,1,101,0,0,0,364
0,0,0,1,101,0,0,0,100
0,0,0,1,101,0,0,0,43
0,0,0,1,101,0,0,0,67
0,0,0,1,101,0,0,0,32
0,0,0,1,101,0,0,0,83
0,0,0,1,101,0,0,0,243
0,0,0,1,101,0,0,0,35
0,0,0,1,101,0,0,0,262
0,0,0,1,101,0,0,0,177
0,0,0,1,101,0,0,0,53
0,0,0,1,101,0,0,0,62
0,0,0,1,101,0,0,0,46
0,0,0,1,101,0,0,0,153
0,0,0,1,101,0,0,0,35
0,0,0,1,101,0,0,0,105
0,0,0,1,101,0,0,0,65
0,0,0,1,101,0,0,0,191
0,0,0,1,101,0,0,0,125
0,0,0,1,101,0,0,0,56
0,0,0,1,101,0,0,0,214
0,0,0,1,101,0,0,0,92
0,0,0,1,101,0,0,0,158
0,0,0,1,101,0,0,0,396
0,0,0,1,101,0,0,0,218
0,0,0,1,101,0,0,0,197
0,0,0,1,101,0,0,0,87
0,0,0,1,101,0,0,0,158
0,0,0,1,101,0,0,0,116
0,0,0,1,101,0,0,0,52
0,0,0,1,101,0,0,0,428
0,0,0,1,101,0,0,0,35
0,0,0,1,101,0,0,0,61
0,0,0,1,101,0,0,0,181
0,0,0,1,101,0,0,0,51
0,0,0,1,101,0,0,0,143
0,0,0,1,101,0,0,0,45
0,0,0,1,101,0,0,0,96
0,0,0,1,101,0,0,0,76
0,0,0,1,101,0,0,0,65
0,0,0,1,101,0,0,0,37
0,0,0,1,101,0,0,0,59
0,0,0,1,101,0,0,0,170
0,0,0,1,101,0,0,0,70
0,0,0,1,101,0,0,0,105
0,0,0,1,101,0,0,0,68
0,0,0,1,101,0,0,0,1359
0,0,0,1,101,0,0,0,93
0,0,0,1,101,0,0,0,51
0,0,0,1,101,0,0,0,60
0,0,0,1,101,0,0,0,117
0,0,0,1,101,0,0,0,100
0,0,0,1,101,0,0,0,54
0,0,0,1,101,0,0,0,54
0,0,0,1,101,0,0,0,51
0,0,0,1,101,0,0,0,80
0,0,0,1,101,0,0,0,36
0,0,0,1,101,0,0,0,51
0,0,0,1,101,0,0,0,293
0,0,0,1,101,0,0,0,62
0,0,0,1,101,0,0,0,40
0,0,0,1,101,0,0,0,113
0,0,0,1,101,0,0,0,68
0,0,0,1,101,0,0,0,127
0,0,0,1,101,0,0,0,433
0,0,0,1,101,0,0,0,290
0,0,0,1,101,0,0,0,18
0,0,0,1,101,0,0,0,122
0,0,0,1,101,0,0,0,150
0,0,0,1,101,0,0,0,253
0,0,0,1,101,0,0,0,67
0,0,0,1,101,0,0,0,129
0,0,0,1,101,0,0,0,97
0,0,0,1,101,0,0,0,80
0,0,0,1,101,0,0,0,189
0,0,0,1,101,0,0,0,855
0,0,0,1,101,0,0,0,378
0,0,0,1,101,0,0,0,194
0,0,0,1,101,0,0,0,60
0,0,0,1,101,0,0,0,109
0,0,0,1,101,0,0,0,39
0,0,0,1,101,0,0,0,122
0,0,0,1,101,0,0,0,54
0,0,0,1,101,0,0,0,119
0,0,0,1,101,0,0,0,54
0,0,0,1,101,0,0,0,43
0,0,0,1,101,0,0,0,83
0,0,0,1,101,0,0,0,56
0,0,0,1,101,0,0,0,117
0,0,0,1,101,0,0,0,250
0,0,0,1,101,0,0,0,92
0,0,0,1,101,0,0,0,157
0,0,0,1,101,0,0,0,67
0,0,0,1,101,0,0,0,324
0,0,0,1,101,0,0,0,127
0,0,0,1,101,0,0,0,378
0,0,0,1,101,0,0,0,42
0,0,0,1,101,0,0,0,54
0,0,0,1,101,0,0,0,73
0,0,0,1,101,0,0,0,39
0,0,0,1,101,0,0,0,929
0,0,0,1,101,0,0,0,686
0,0,0,1,101,0,0,0,177
0,0,0,1,101,0,0,0,36
0,0,0,1,101,0,0,0,19
0,0,0,1,101,0,0,0,513
0,0,0,1,101,0,0,0,554
0,0,0,1,101,0,0,0,760
0,0,0,1,101,0,0,0,2524
0,0,0,1,101,0,0,0,2680
0,0,0,1,101,0,0,0,739
0,0,0,1,101,0,0,0,1384
0,0,0,1,101,0,0,0,763
0,0,0,1,101,0,0,0,1002
0,0,0,1,101,0,0,0,39
0,0,0,1,101,0,0,0,177
0,0,0,1,101,0,0,0,94
0,0,0,1,101,0,0,0,55
0,0,0,1,101,0,0,0,178
0,0,0,1,101,0,0,0,14
0,0,0,1,101,0,0,0,12
0,0,0,1,101,0,0,0,76
0,0,0,1,101,0,0,0,175
0,0,0,1,101,0,0,0,61
0,0,0,1,101,0,0,0,757
0,0,0,1,101,0,0,0,233
0,0,0,1,101,0,0,0,53
0,0,0,1,101,0,0,0,165
0,0,0,1,101,0,0,0,297
0,0,0,1,101,0,0,0,524
0,0,0,1,101,0,0,0,873
0,0,0,1,101,0,0,0,82
0,0,0,1,101,0,0,0,224
0,0,0,1,101,0,0,0,194
0,0,0,1,101,0,0,0,78
0,0,0,1,101,0,0,0,186
0,0,0,1,101,0,0,0,103
0,0,0,1,101,0,0,0,128
0,0,0,1,101,0,0,0,189
0,0,0,1,101,0,0,0,2034
0,0,0,1,101,0,0,0,218
0,0,0,1,101,0,0,0,990
0,0,0,1,101,0,0,0,167
0,0,0,1,101,0,0,0,315
0,0,0,1,101,0,0,0,148
0,0,0,1,101,0,0,0,165
0,0,0,1,101,0,0,0,276
0,0,0,1,101,0,0,0,247
0,0,0,1,101,0,0,0,241
0,0,0,1,101,0,0,0,91
0,0,0,1,101,0,0,0,678
0,0,0,1,101,0,0,0,366
0,0,0,1,101,0,0,0,129
0,0,0,1,101,0,0,0,79
0,0,0,1,101,0,0,0,18
0,0,0,1,101,0,0,0,223
0,0,0,1,101,0,0,0,160
0,0,0,1,101,0,0,0,75
0,0,0,1,101,0,0,0,120
0,0,0,1,101,0,0,0,215
0,0,0,1,101,0,0,0,553
0,0,0,1,101,0,0,0,83
0,0,0,1,101,0,0,0,457
0,0,0,1,101,0,0,0,101
0,0,0,1,101,0,0,0,221
0,0,0,1,101,0,0,0,23
0,0,0,1,101,0,0,0,1347
0,0,0,1,101,0,0,0,18
0,0,0,1,101,0,0,0,141
0,0,0,1,101,0,0,0,1295
0,0,0,1,101,0,0,0,153
0,0,0,1,101,0,0,0,97
0,0,0,1,101,0,0,0,413
0,0,0,1,101,0,0,0,82
0,0,0,1,101,0,0,0,140
0,0,0,1,101,0,0,0,144
0,0,0,1,101,0,0,0,18
0,0,0,1,101,0,0,0,47
0,0,0,1,101,0,0,0,95
0,0,0,1,101,0,0,0,112
0,0,0,1,101,0,0,0,41
0,0,0,1,101,0,0,0,160
0,0,0,1,101,0,0,0,77
0,0,0,1,101,0,0,0,77
0,0,0,1,101,0,0,0,106
0,0,0,1,101,0,0,0,143
0,0,0,1,101,0,0,0,254
0,0,0,1,101,0,0,0,40
0,0,0,1,101,0,0,0,4509
0,0,0,1,101,0,0,0,222
0,0,0,1,101,0,0,0,111
0,0,0,1,101,0,0,0,81
0,0,0,1,101,0,0,0,114
0,0,0,1,101,0,0,0,673
0,0,0,1,101,0,0,0,645
0,0,0,1,101,0,0,0,4298
0,0,0,1,101,0,0,0,571
0,0,0,1,101,0,0,0,175
0,0,0,1,101,0,0,0,1220
0,0,0,1,101,0,0,0,75
0,0,0,1,101,0,0,0,354
0,0,0,1,101,0,0,0,142
0,0,0,1,101,0,0,0,709
0,0,0,1,101,0,0,0,208
0,0,0,1,101,0,0,0,875
0,0,0,1,101,0,0,0,18
0,0,0,1,101,0,0,0,308
0,0,0,1,101,0,0,0,62
0,0,0,1,101,0,0,0,70
0,0,0,1,101,0,0,0,96
0,0,0,1,101,0,0,0,833
0,0,0,1,101,0,0,0,350
0,0,0,1,101,0,0,0,193
0,0,0,1,101,0,0,0,86
0,0,0,1,101,0,0,0,98
0,0,0,1,101,0,0,0,140
0,0,0,1,101,0,0,0,149
0,0,0,1,101,0,0,0,93
0,0,0,1,101,0,0,0,148
0,0,0,1,101,0,0,0,39
0,0,0,1,101,0,0,0,419
0,0,0,1,101,0,0,0,92
0,0,0,1,101,0,0,0,320
0,0,0,1,101,0,0,0,432
0,0,0,1,101,0,0,0,261
0,0,0,1,101,0,0,0,482
0,0,0,1,101,0,0,0,161
0,0,0,1,101,0,0,0,127
0,0,0,1,101,0,0,0,93
0,0,0,1,101,0,0,0,56
0,0,0,1,101,0,0,0,349
0,0,0,1,101,0,0,0,21
0,0,0,1,101,0,0,0,72
0,0,0,1,101,0,0,0,140
0,0,0,1,101,0,0,0,150
0,0,0,1,101,0,0,0,111
0,0,0,1,101,0,0,0,128
0,0,0,1,101,0,0,0,64
0,0,0,1,101,0,0,0,103
0,0,0,1,101,0,0,0,181
0,0,0,1,101,0,0,0,104
0,0,0,1,101,0,0,0,88
0,0,0,1,101,0,0,0,89
0,0,0,1,101,0,0,0,75
0,0,0,1,101,0,0,0,153
0,0,0,1,101,0,0,0,116
0,0,0,1,101,0,0,0,305
0,0,0,1,101,0,0,0,275
0,0,0,1,101,0,0,0,127
0,0,0,1,101,0,0,0,257
0,0,0,1,101,0,0,0,153
0,0,0,1,101,0,0,0,78
0,0,0,1,101,0,0,0,927
0,0,0,1,101,0,0,0,112
0,0,0,1,101,0,0,0,283
0,0,0,1,101,0,0,0,140
0,0,0,1,101,0,0,0,51
0,0,0,1,101,0,0,0,1521
0,0,0,1,101,0,0,0,26
0,0,0,1,101,0,0,0,226
0,0,0,1,101,0,0,0,122
0,0,0,1,101,0,0,0,74
0,0,0,1,101,0,0,0,65
0,0,0,1,101,0,0,0,56
0,0,0,1,101,0,0,0,68
0,0,0,1,101,0,0,0,101
0,0,0,1,101,0,0,0,353
0,0,0,1,101,0,0,0,533
0,0,0,1,101,0,0,0,72
0,0,0,1,101,0,0,0,202
0,0,0,1,101,0,0,0,139
0,0,0,1,101,0,0,0,196
0,0,0,1,101,0,0,0,300
0,0,0,1,101,0,0,0,55
0,0,0,1,101,0,0,0,67
0,0,0,1,101,0,0,0,100
0,0,0,1,101,0,0,0,44
0,0,0,1,101,0,0,0,69
0,0,0,1,101,0,0,0,49
0,0,0,1,101,0,0,0,94
0,0,0,1,101,0,0,0,37
0,0,0,1,101,0,0,0,35
0,0,0,1,101,0,0,0,35
0,0,0,1,101,0,0,0,165
0,0,0,1,101,0,0,0,95
0,0,0,1,101,0,0,0,174
0,0,0,1,101,0,0,0,114
0,0,0,1,101,0,0,0,20
0,0,0,1,101,0,0,0,54
0,0,0,1,101,0,0,0,28
0,0,0,1,101,0,0,0,72
0,0,0,1,101,0,0,0,109
0,0,0,1,101,0,0,0,137
0,0,0,1,101,0,0,0,145
0,0,0,1,101,0,0,0,161
0,0,0,1,101,0,0,0,99
0,0,0,1,101,0,0,0,59
0,0,0,1,101,0,0,0,41
0,0,0,1,101,0,0,0,66
0,0,0,1,101,0,0,0,53
0,0,0,1,101,0,0,0,188
0,0,0,1,101,0,0,0,117
0,0,0,1,101,0,0,0,709
0,0,0,1,101,0,0,0,756
0,0,0,1,101,0,0,0,84
0,0,0,1,101,0,0,0,111
0,0,0,1,101,0,0,0,109
0,0,0,1,101,0,0,0,564
0,0,0,1,101,0,0,0,493
0,0,0,1,101,0,0,0,91
0,0,0,1,101,0,0,0,74
0,0,0,1,101,0,0,0,312
0,0,0,1,101,0,0,0,1213
0,0,0,1,101,0,0,0,146
0,0,0,1,101,0,0,0,876
0,0,0,1,101,0,0,0,353
0,0,0,1,101,0,0,0,256
0,0,0,1,101,0,0,0,2007
0,0,0,1,101,0,0,0,190
0,0,0,1,101,0,0,0,325
0,0,0,1,101,0,0,0,100
0,0,0,1,101,0,0,0,37
0,0,0,1,101,0,0,0,114
0,0,0,1,101,0,0,0,65
0,0,0,1,101,0,0,0,88
0,0,0,1,101,0,0,0,46
0,0,0,1,101,0,0,0,49
0,0,0,1,101,0,0,0,38
0,0,0,1,101,0,0,0,66
0,0,0,1,101,0,0,0,85
0,0,0,1,101,0,0,0,47
0,0,0,1,101,0,0,0,46
0,0,0,1,101,0,0,0,19
0,0,0,1,101,0,0,0,987
0,0,0,1,101,0,0,0,759
0,0,0,1,101,0,0,0,491
0,0,0,1,101,0,0,0,22
0,0,0,1,101,0,0,0,70
0,0,0,1,101,0,0,0,65
0,0,0,1,101,0,0,0,46
0,0,0,1,101,0,0,0,45
0,0,0,1,101,0,0,0,38
0,0,0,1,101,0,0,0,65
0,0,0,1,101,0,0,0,46
0,0,0,1,101,0,0,0,45
0,0,0,1,101,0,0,0,38
0,0,0,1,101,0,0,0,107
0,0,0,1,101,0,0,0,145
0,0,0,1,101,0,0,0,65
0,0,0,1,101,0,0,0,31
0,0,0,1,101,0,0,0,76
0,0,0,1,101,0,0,0,71
0,0,0,1,101,0,0,0,56
0,0,0,1,101,0,0,0,65
0,0,0,1,101,0,0,0,30
0,0,0,1,101,0,0,0,93
0,0,0,1,101,0,0,0,53
0,0,0,1,101,0,0,0,179
0,0,0,1,101,0,0,0,45
0,0,0,1,101,0,0,0,29
0,0,0,1,101,0,0,0,37
0,0,0,1,101,0,0,0,173
0,0,0,1,101,0,0,0,140
0,0,0,1,101,0,0,0,50
0,0,0,1,101,0,0,0,89
0,0,0,1,101,0,0,0,42
0,0,0,1,101,0,0,0,6
0,0,0,1,101,0,0,0,356
0,0,0,1,101,0,0,0,5
0,0,0,1,101,0,0,0,72
0,0,0,1,101,0,0,0,79
0,0,0,1,101,0,0,0,46
0,0,0,1,101,0,0,0,52
0,0,0,1,101,0,0,0,84
0,0,0,1,101,0,0,0,176
0,0,0,1,101,0,0,0,123
0,0,0,1,101,0,0,0,67
0,0,0,1,101,0,0,0,386
0,0,0,1,101,0,0,0,117
0,0,0,1,101,0,0,0,218
0,0,0,1,101,0,0,0,341
0,0,0,1,101,0,0,0,312
0,0,0,1,101,0,0,0,52
0,0,0,1,101,0,0,0,25
0,0,0,1,101,0,0,0,76
0,0,0,1,101,0,0,0,30
0,0,0,1,101,0,0,0,40
0,0,0,1,101,0,0,0,30
0,0,0,1,101,0,0,0,36
0,0,0,1,101,0,0,0,30
0,0,0,1,101,0,0,0,30
0,0,0,1,101,0,0,0,31
0,0,0,1,101,0,0,0,34
0,0,0,1,101,0,0,0,34
0,0,0,1,101,0,0,0,34
0,0,0,1,101,0,0,0,30
0,0,0,1,101,0,0,0,36
0,0,0,1,101,0,0,0,34
0,0,0,1,101,0,0,0,32
0,0,0,1,101,0,0,0,30
0,0,0,1,101,0,0,0,30
0,0,0,1,101,0,0,0,30
0,0,0,1,101,0,0,0,40
0,0,0,1,101,0,0,0,31
0,0,0,1,101,0,0,0,30
0,0,0,1,101,0,0,0,30
0,0,0,1,101,0,0,0,30
0,0,0,1,101,0,0,0,30
0,0,0,1,101,0,0,0,30
0,0,0,1,101,0,0,0,31
0,0,0,1,101,0,0,0,30
0,0,0,1,101,0,0,0,34
0,0,0,1,101,0,0,0,37
0,0,0,1,101,0,0,0,34
0,0,0,1,101,0,0,0,34
0,0,0,1,101,0,0,0,46
0,0,0,1,101,0,0,0,35
0,0,0,1,101,0,0,0,43
0,0,0,1,101,0,0,0,35
0,0,0,1,101,0,0,0,35
0,0,0,1,101,0,0,0,30
0,0,0,1,101,0,0,0,36
0,0,0,1,101,0,0,0,30
0,0,0,1,101,0,0,0,50
0,0,0,1,101,0,0,0,30
0,0,0,1,101,0,0,0,30
0,0,0,1,101,0,0,0,30
0,0,0,1,101,0,0,0,80
0,0,0,1,101,0,0,0,30
0,0,0,1,101,0,0,0,49
0,0,0,1,101,0,0,0,30
0,0,0,1,101,0,0,0,31
0,0,0,1,101,0,0,0,30
0,0,0,1,101,0,0,0,30
0,0,0,1,101,0,0,0,30
0,0,0,1,101,0,0,0,30
0,0,0,1,101,0,0,0,30
0,0,0,1,101,0,0,0,30
0,0,0,1,101,0,0,0,36
0,0,0,1,101,0,0,0,37
0,0,0,1,101,0,0,0,30
0,0,0,1,101,0,0,0,83
0,0,0,1,101,0,0,0,30
0,0,0,1,101,0,0,0,37
0,0,0,1,101,0,0,0,660
0,0,0,1,101,0,0,0,2103
0,0,0,1,101,0,0,0,433
0,0,0,1,101,0,0,0,106
0,0,0,1,101,0,0,0,575
0,0,0,1,101,0,0,0,146
0,0,0,2,100,0,0,0,34
0,0,0,1,101,0,0,0,248
0,0,0,1,101,0,0,0,222
0,0,0,1,101,0,0,0,420
0,0,0,1,101,0,0,0,293
0,0,0,1,101,0,0,0,444
0,0,0,1,101,0,0,0,1091
0,0,0,1,101,0,0,0,134
0,0,0,1,101,0,0,0,632
0,0,0,1,101,0,0,0,374
0,0,0,1,101,0,0,0,337
0,0,0,1,101,0,0,0,43
0,0,0,1,101,0,0,0,348
0,0,0,1,101,0,0,0,179
0,0,0,1,101,0,0,0,873
0,0,0,1,101,0,0,0,196
0,0,0,1,101,0,0,0,742
0,0,0,1,101,0,0,0,103
0,0,0,1,101,0,0,0,223
0,0,0,1,101,0,0,0,405
0,0,0,1,101,0,0,0,345
0,0,0,1,101,0,0,0,371
0,0,0,1,101,0,0,0,73
0,0,0,1,101,0,0,0,393
0,0,0,1,101,0,0,0,527
0,0,0,1,101,0,0,0,145
0,0,0,1,101,0,0,0,109
0,0,0,1,101,0,0,0,167
0,0,0,1,101,0,0,0,136
0,0,0,1,101,0,0,0,514
0,0,0,1,101,0,0,0,188
0,0,0,1,101,0,0,0,74
0,0,0,1,101,0,0,0,178
0,0,0,1,101,0,0,0,138
0,0,0,1,101,0,0,0,141
0,0,0,1,101,0,0,0,510
0,0,0,1,101,0,0,0,243
0,0,0,1,101,0,0,0,856
0,0,0,1,101,0,0,0,182
0,0,0,1,101,0,0,0,92
0,0,0,1,101,0,0,0,311
0,0,0,1,101,0,0,0,843
0,0,0,1,101,0,0,0,271
0,0,0,1,101,0,0,0,877
0,0,0,1,101,0,0,0,208
0,0,0,1,101,0,0,0,96
0,0,0,1,101,0,0,0,61
0,0,0,1,101,0,0,0,297
0,0,0,1,101,0,0,0,682
0,0,0,1,101,0,0,0,226
0,0,0,1,101,0,0,0,820
0,0,0,1,101,0,0,0,2577
0,0,0,1,101,0,0,0,148
0,0,0,1,101,0,0,0,33
0,0,0,1,101,0,0,0,2023
0,0,0,1,101,0,0,0,287
0,0,0,1,101,0,0,0,1684
0,0,0,1,101,0,0,0,189
0,0,0,1,101,0,0,0,109
0,0,0,1,101,0,0,0,43
0,0,0,1,101,0,0,0,110
0,0,0,1,101,0,0,0,36
0,0,0,1,101,0,0,0,45
0,0,0,1,101,0,0,0,40
0,0,0,1,101,0,0,0,82
0,0,0,1,101,0,0,0,90
0,0,0,1,101,0,0,0,352
0,0,0,1,101,0,0,0,379
0,0,0,1,101,0,0,0,387
0,0,0,1,101,0,0,0,1278
0,0,0,1,101,0,0,0,637
0,0,0,1,101,0,0,0,216
0,0,0,1,101,0,0,0,317
0,0,0,1,101,0,0,0,225
0,0,0,1,101,0,0,0,143
0,0,0,1,101,0,0,0,121
0,0,0,1,101,0,0,0,412
0,0,0,1,101,0,0,0,147
0,0,0,1,101,0,0,0,1563
0,0,0,1,101,0,0,0,261
0,0,0,1,101,0,0,0,814
0,0,0,1,101,0,0,0,259
0,0,0,1,101,0,0,0,99
0,0,0,1,101,0,0,0,181
0,0,0,1,101,0,0,0,4050
0,0,0,1,101,0,0,0,288
0,0,0,1,101,0,0,0,207
0,0,0,1,101,0,0,0,245
0,0,0,1,101,0,0,0,410
0,0,0,1,101,0,0,0,85
0,0,0,1,101,0,0,0,268
0,0,0,1,101,0,0,0,353
0,0,0,1,101,0,0,0,534
0,0,0,1,101,0,0,0,124
0,0,0,1,101,0,0,0,1258
0,0,0,1,101,0,0,0,297
0,0,0,1,101,0,0,0,460
0,0,0,1,101,0,0,0,975
0,0,0,1,101,0,0,0,106
0,0,0,1,101,0,0,0,89
0,0,0,1,101,0,0,0,205
0,0,0,1,101,0,0,0,162
0,0,0,1,101,0,0,0,430
0,0,0,1,101,0,0,0,115
0,0,0,1,101,0,0,0,266
0,0,0,1,101,0,0,0,190
0,0,0,1,101,0,0,0,350
0,0,0,1,101,0,0,0,1021
0,0,0,1,101,0,0,0,32
0,0,0,1,101,0,0,0,155
0,0,0,1,101,0,0,0,291
0,0,0,1,101,0,0,0,1060
0,0,0,1,101,0,0,0,4463
0,0,0,1,101,0,0,0,131
0,0,0,1,101,0,0,0,262
0,0,0,1,101,0,0,0,230
0,0,0,1,101,0,0,0,439
0,0,0,1,101,0,0,0,678
0,0,0,1,101,0,0,0,261
0,0,0,1,101,0,0,0,269
0,0,0,1,101,0,0,0,72
0,0,0,1,101,0,0,0,68
0,0,0,1,101,0,0,0,71
0,0,0,1,101,0,0,0,160
0,0,0,1,101,0,0,0,607
0,0,0,1,101,0,0,0,53
0,0,0,1,101,0,0,0,306
0,0,0,1,101,0,0,0,186
0,0,0,1,101,0,0,0,489
0,0,0,1,101,0,0,0,443
0,0,0,1,101,0,0,0,310
0,0,0,1,101,0,0,0,299
0,0,0,1,101,0,0,0,187
0,0,0,1,101,0,0,0,285
0,0,0,1,101,0,0,0,137
0,0,0,1,101,0,0,0,38
0,0,0,1,101,0,0,0,1752
0,0,0,1,101,0,0,0,216
0,0,0,1,101,0,0,0,248
0,0,0,1,101,0,0,0,112
0,0,0,1,101,0,0,0,489
0,0,0,1,101,0,0,0,367
0,0,0,1,101,0,0,0,55
0,0,0,1,101,0,0,0,280
0,0,0,1,101,0,0,0,134
0,0,0,1,101,0,0,0,264
0,0,0,1,101,0,0,0,427
0,0,0,1,101,0,0,0,40
0,0,0,1,101,0,0,0,454
0,0,0,1,101,0,0,0,75
0,0,0,1,101,0,0,0,295
0,0,0,1,101,0,0,0,1555
0,0,0,1,101,0,0,0,1431
0,0,0,1,101,0,0,0,261
0,0,0,1,101,0,0,0,65
0,0,0,1,101,0,0,0,471
0,0,0,1,101,0,0,0,429
0,0,0,1,101,0,0,0,224
0,0,0,1,101,0,0,0,971
0,0,0,1,101,0,0,0,434
0,0,0,1,101,0,0,0,174
0,0,0,1,101,0,0,0,336
0,0,0,1,101,0,0,0,108
0,0,0,1,101,0,0,0,131
0,0,0,1,101,0,0,0,183
0,0,0,1,101,0,0,0,109
0,0,0,1,101,0,0,0,248
0,0,0,1,101,0,0,0,175
0,0,0,1,101,0,0,0,88
0,0,0,1,101,0,0,0,137
0,0,0,1,101,0,0,0,301
0,0,0,1,101,0,0,0,206
0,0,0,1,101,0,0,0,39
0,0,0,1,101,0,0,0,371
0,0,0,1,101,0,0,0,170
0,0,0,1,101,0,0,0,95
0,0,0,1,101,0,0,0,37
0,0,0,1,101,0,0,0,924
0,0,0,1,101,0,0,0,244
0,0,0,1,101,0,0,0,165
0,0,0,1,101,0,0,0,146
0,0,0,1,101,0,0,0,521
0,0,0,1,101,0,0,0,294
0,0,0,1,101,0,0,0,47
0,0,0,1,101,0,0,0,43
0,0,0,1,101,0,0,0,43
0,0,0,1,101,0,0,0,51
0,0,0,1,101,0,0,0,142
0,0,0,1,101,0,0,0,46
0,0,0,1,101,0,0,0,524
0,0,0,1,101,0,0,0,51
0,0,0,1,101,0,0,0,84
0,0,0,1,101,0,0,0,53
0,0,0,1,101,0,0,0,847
0,0,0,1,101,0,0,0,119
0,0,0,1,101,0,0,0,318
0,0,0,1,101,0,0,0,195
0,0,0,1,101,0,0,0,198
0,0,0,1,101,0,0,0,338
0,0,0,1,101,0,0,0,519
0,0,0,1,101,0,0,0,1969
0,0,0,1,101,0,0,0,1286
0,0,0,1,101,0,0,0,1021
0,0,0,1,101,0,0,0,176
0,0,0,1,101,0,0,0,342
0,0,0,1,101,0,0,0,121
0,0,0,1,101,0,0,0,61
0,0,0,1,101,0,0,0,156
0,0,0,1,101,0,0,0,65
0,0,0,1,101,0,0,0,326
0,0,0,1,101,0,0,0,116
0,0,0,1,101,0,0,0,214
0,0,0,1,101,0,0,0,381
0,0,0,1,101,0,0,0,98
0,0,0,1,101,0,0,0,245
0,0,0,1,101,0,0,0,436
0,0,0,1,101,0,0,0,578
0,0,0,1,101,0,0,0,941
0,0,0,1,101,0,0,0,224
0,0,0,1,101,0,0,0,309
0,0,0,1,101,0,0,0,167
0,0,0,1,101,0,0,0,283
0,0,0,1,101,0,0,0,182
0,0,0,1,101,0,0,0,200
0,0,0,1,101,0,0,0,160
0,0,0,1,101,0,0,0,1169
0,0,0,1,101,0,0,0,1538
0,0,0,1,101,0,0,0,261
0,0,0,1,101,0,0,0,145
0,0,0,1,101,0,0,0,415
0,0,0,1,101,0,0,0,146
0,0,0,1,101,0,0,0,670
0,0,0,1,101,0,0,0,189
0,0,0,1,101,0,0,0,115
0,0,0,1,101,0,0,0,256
0,0,0,1,101,0,0,0,344
0,0,0,1,101,0,0,0,54
0,0,0,1,101,0,0,0,172
0,0,0,1,101,0,0,0,269
0,0,0,1,101,0,0,0,154
0,0,0,1,101,0,0,0,244
0,0,0,1,101,0,0,0,545
0,0,0,1,101,0,0,0,295
0,0,0,1,101,0,0,0,100
0,0,0,1,101,0,0,0,1831
0,0,0,1,101,0,0,0,357
0,0,0,1,101,0,0,0,147
0,0,0,1,101,0,0,0,1341
0,0,0,1,101,0,0,0,100
0,0,0,1,101,0,0,0,189
0,0,0,1,101,0,0,0,276
0,0,0,1,101,0,0,0,85
0,0,0,1,101,0,0,0,488
0,0,0,1,101,0,0,0,143
0,0,0,1,101,0,0,0,73
0,0,0,1,101,0,0,0,169
0,0,0,1,101,0,0,0,105
0,0,0,1,101,0,0,0,102
0,0,0,1,101,0,0,0,87
0,0,0,1,101,0,0,0,282
0,0,0,1,101,0,0,0,308
0,0,0,1,101,0,0,0,3157
0,0,0,1,101,0,0,0,345
0,0,0,1,101,0,0,0,190
0,0,0,1,101,0,0,0,84
0,0,0,1,101,0,0,0,104
0,0,0,1,101,0,0,0,522
0,0,0,1,101,0,0,0,1049
0,0,0,1,101,0,0,0,1774
0,0,0,1,101,0,0,0,204
0,0,0,1,101,0,0,0,406
0,0,0,1,101,0,0,0,169
0,0,0,1,101,0,0,0,1497
0,0,0,1,101,0,0,0,158
0,0,0,1,101,0,0,0,464
0,0,0,1,101,0,0,0,297
0,0,0,1,101,0,0,0,101
0,0,0,1,101,0,0,0,170
0,0,0,1,101,0,0,0,1701
0,0,0,1,101,0,0,0,189
0,0,0,1,101,0,0,0,114
0,0,0,1,101,0,0,0,70
0,0,0,1,101,0,0,0,68
0,0,0,1,101,0,0,0,182
0,0,0,1,101,0,0,0,820
0,0,0,1,101,0,0,0,69
0,0,0,1,101,0,0,0,89
0,0,0,1,101,0,0,0,519
0,0,0,1,101,0,0,0,35
0,0,0,1,101,0,0,0,520
0,0,0,1,101,0,0,0,140
0,0,0,1,101,0,0,0,166
0,0,0,1,101,0,0,0,1113
0,0,0,1,101,0,0,0,299
0,0,0,1,101,0,0,0,153
0,0,0,1,101,0,0,0,136
0,0,0,1,101,0,0,0,295
0,0,0,1,101,0,0,0,129
0,0,0,1,101,0,0,0,285
0,0,0,1,101,0,0,0,1070
0,0,0,1,101,0,0,0,119
0,0,0,1,101,0,0,0,135
0,0,0,1,101,0,0,0,212
0,0,0,1,101,0,0,0,694
0,0,0,1,101,0,0,0,255
0,0,0,1,101,0,0,0,44
0,0,0,1,101,0,0,0,90
0,0,0,1,101,0,0,0,337
0,0,0,1,101,0,0,0,144
0,0,0,1,101,0,0,0,882
0,0,0,1,101,0,0,0,171
0,0,0,1,101,0,0,0,321
0,0,0,1,101,0,0,0,3362
0,0,0,1,101,0,0,0,59
0,0,0,1,101,0,0,0,504
0,0,0,1,101,0,0,0,66
0,0,0,1,101,0,0,0,51
0,0,0,1,101,0,0,0,227
0,0,0,1,101,0,0,0,136
0,0,0,1,101,0,0,0,635
0,0,0,1,101,0,0,0,706
0,0,0,1,101,0,0,0,582
0,0,0,1,101,0,0,0,152
0,0,0,2,100,0,0,0,77
0,0,0,2,100,0,0,0,66
0,0,0,2,100,0,0,0,169
0,0,0,2,100,0,0,0,15
0,0,0,1,101,0,0,0,42
0,0,0,2,100,0,0,0,63
0,0,0,1,101,0,0,0,130
0,0,0,2,100,0,0,0,100
0,0,0,2,100,0,0,0,49
0,0,0,1,101,0,0,0,207
0,0,0,1,101,0,0,0,80
0,0,0,2,100,0,0,0,122
0,0,0,2,100,0,0,0,74
0,0,0,2,100,0,0,0,24
0,0,0,1,101,0,0,0,2704
0,0,0,1,101,0,0,0,4494
0,0,0,1,101,0,0,0,754
0,0,0,1,101,0,0,0,340
0,0,0,1,101,0,0,0,4724
0,0,0,1,101,0,0,0,838
0,0,0,1,101,0,0,0,11
0,0,0,1,101,0,0,0,39
0,0,0,1,101,0,0,0,256
0,0,0,1,101,0,0,0,22
0,0,0,1,101,0,0,0,352
0,0,0,1,101,0,0,0,26
0,0,0,1,101,0,0,0,359
0,0,0,1,101,0,0,0,107
0,0,0,1,101,0,0,0,524
0,0,0,1,101,0,0,0,1263
0,0,0,1,101,0,0,0,514
0,0,0,1,101,0,0,0,41
0,0,0,1,101,0,0,0,43
0,0,0,1,101,0,0,0,98
0,0,0,1,101,0,0,0,566
0,0,0,1,101,0,0,0,455
0,0,0,1,101,0,0,0,240
0,0,0,1,101,0,0,0,241
0,0,0,1,101,0,0,0,206
0,0,0,1,101,0,0,0,244
0,0,0,1,101,0,0,0,519
0,0,0,1,101,0,0,0,59
0,0,0,1,101,0,0,0,165
0,0,0,1,101,0,0,0,135
0,0,0,1,101,0,0,0,55
0,0,0,1,101,0,0,0,112
0,0,0,1,101,0,0,0,83
0,0,0,1,101,0,0,0,149
0,0,0,1,101,0,0,0,1419
0,0,0,1,101,0,0,0,329
0,0,0,1,101,0,0,0,527
0,0,0,1,101,0,0,0,278
0,0,0,1,101,0,0,0,2701
0,0,0,1,101,0,0,0,548
0,0,0,1,101,0,0,0,707
0,0,0,1,101,0,0,0,318
0,0,0,1,101,0,0,0,512
0,0,0,1,101,0,0,0,502
0,0,0,1,101,0,0,0,273
0,0,0,1,101,0,0,0,80
0,0,0,1,101,0,0,0,2352
0,0,0,1,101,0,0,0,2390
0,0,0,1,101,0,0,0,2165
0,0,0,1,101,0,0,0,759
0,0,0,1,101,0,0,0,1679
0,0,0,1,101,0,0,0,155
0,0,0,1,101,0,0,0,1143
0,0,0,1,101,0,0,0,688
0,0,0,1,101,0,0,0,724
0,0,0,1,101,0,0,0,381
0,0,0,1,101,0,0,0,966
0,0,0,1,101,0,0,0,31
0,0,0,1,101,0,0,0,549
0,0,0,1,101,0,0,0,27
0,0,0,1,101,0,0,0,2162
0,0,0,1,101,0,0,0,265
0,0,0,1,101,0,0,0,55
0,0,0,1,101,0,0,0,32
0,0,0,1,101,0,0,0,494
0,0,0,1,101,0,0,0,281
0,0,0,1,101,0,0,0,361
0,0,0,1,101,0,0,0,129
0,0,0,1,101,0,0,0,3
0,0,0,1,101,0,0,0,508
0,0,0,1,101,0,0,0,1781
0,0,0,1,101,0,0,0,217
0,0,0,1,101,0,0,0,126
0,0,0,1,101,0,0,0,206
0,0,0,1,101,0,0,0,102
0,0,0,1,101,0,0,0,146
0,0,0,1,101,0,0,0,265
0,0,0,1,101,0,0,0,577
0,0,0,1,101,0,0,0,334
0,0,0,1,101,0,0,0,2135
0,0,0,1,101,0,0,0,103
0,0,0,1,101,0,0,0,2074
0,0,0,1,101,0,0,0,258
0,0,0,1,101,0,0,0,2867
0,0,0,1,101,0,0,0,222
0,0,0,1,101,0,0,0,760
0,0,0,1,101,0,0,0,36
0,0,0,1,101,0,0,0,43
0,0,0,1,101,0,0,0,384
0,0,0,1,101,0,0,0,864
0,0,0,1,101,0,0,0,992
0,0,0,1,101,0,0,0,135
0,0,0,1,101,0,0,0,520
0,0,0,1,101,0,0,0,338
0,0,0,1,101,0,0,0,181
0,0,0,1,101,0,0,0,66
0,0,0,1,101,0,0,0,591
0,0,0,1,101,0,0,0,534
0,0,0,1,101,0,0,0,92
0,0,0,1,101,0,0,0,166
0,0,0,1,101,0,0,0,284
0,0,0,1,101,0,0,0,232
0,0,0,1,101,0,0,0,1022
0,0,0,1,101,0,0,0,156
0,0,0,1,101,0,0,0,798
0,0,0,1,101,0,0,0,920
0,0,0,1,101,0,0,0,364
0,0,0,1,101,0,0,0,918
0,0,0,1,101,0,0,0,379
0,0,0,1,101,0,0,0,909
0,0,0,1,101,0,0,0,383
0,0,0,1,101,0,0,0,142
0,0,0,1,101,0,0,0,94
0,0,0,1,101,0,0,0,495
0,0,0,1,101,0,0,0,28
0,0,0,1,101,0,0,0,506
0,0,0,1,101,0,0,0,88
0,0,0,1,101,0,0,0,283
0,0,0,1,101,0,0,0,64
0,0,0,1,101,0,0,0,1496
0,0,0,1,101,0,0,0,3360
0,0,0,1,101,0,0,0,325
0,0,0,1,101,0,0,0,121
0,0,0,1,101,0,0,0,792
0,0,0,1,101,0,0,0,494
0,0,0,1,101,0,0,0,502
0,0,0,1,101,0,0,0,905
0,0,0,1,101,0,0,0,216
0,0,0,1,101,0,0,0,773
0,0,0,1,101,0,0,0,630
0,0,0,1,101,0,0,0,226
0,0,0,1,101,0,0,0,534
0,0,0,1,101,0,0,0,1729
0,0,0,1,101,0,0,0,131
0,0,0,1,101,0,0,0,795
0,0,0,1,101,0,0,0,1026
0,0,0,1,101,0,0,0,230
0,0,0,1,101,0,0,0,771
0,0,0,1,101,0,0,0,54
0,0,0,1,101,0,0,0,1069
0,0,0,1,101,0,0,0,1363
0,0,0,1,101,0,0,0,601
0,0,0,1,101,0,0,0,555
0,0,0,1,101,0,0,0,1152
0,0,0,1,101,0,0,0,906
0,0,0,1,101,0,0,0,762
0,0,0,1,101,0,0,0,225
0,0,0,1,101,0,0,0,188
0,0,0,1,101,0,0,0,207
0,0,0,1,101,0,0,0,207
0,0,0,1,101,0,0,0,87
0,0,0,1,101,0,0,0,431
0,0,0,1,101,0,0,0,183
0,0,0,1,101,0,0,0,105
0,0,0,1,101,0,0,0,380
0,0,0,1,101,0,0,0,157
0,0,0,1,101,0,0,0,179
0,0,0,1,101,0,0,0,355
0,0,0,1,101,0,0,0,623
0,0,0,1,101,0,0,0,59
0,0,0,1,101,0,0,0,1836
0,0,0,1,101,0,0,0,178
0,0,0,1,101,0,0,0,219
0,0,0,1,101,0,0,0,1656
0,0,0,1,101,0,0,0,306
0,0,0,1,101,0,0,0,329
0,0,0,1,101,0,0,0,697
0,0,0,1,101,0,0,0,207
0,0,0,1,101,0,0,0,192
0,0,0,1,101,0,0,0,1008
0,0,0,1,101,0,0,0,60
0,0,0,1,101,0,0,0,932
0,0,0,1,101,0,0,0,88
0,0,0,1,101,0,0,0,265
0,0,0,1,101,0,0,0,69
0,0,0,1,101,0,0,0,2651
0,0,0,1,101,0,0,0,2104
0,0,0,1,101,0,0,0,131
0,0,0,1,101,0,0,0,34
0,0,0,1,101,0,0,0,42
0,0,0,1,101,0,0,0,205
0,0,0,1,101,0,0,0,307
0,0,0,1,101,0,0,0,368
0,0,0,1,101,0,0,0,163
0,0,0,1,101,0,0,0,293
0,0,0,1,101,0,0,0,337
0,0,0,1,101,0,0,0,331
0,0,0,1,101,0,0,0,3454
0,0,0,1,101,0,0,0,1460
0,0,0,1,101,0,0,0,2266
0,0,0,1,101,0,0,0,795
0,0,0,1,101,0,0,0,317
0,0,0,1,101,0,0,0,716
0,0,0,1,101,0,0,0,117
0,0,0,1,101,0,0,0,1547
0,0,0,1,101,0,0,0,64
0,0,0,1,101,0,0,0,766
0,0,0,1,101,0,0,0,284
0,0,0,1,101,0,0,0,1016
0,0,0,1,101,0,0,0,303
0,0,0,1,101,0,0,0,316
0,0,0,1,101,0,0,0,139
0,0,0,1,101,0,0,0,84
0,0,0,1,101,0,0,0,296
0,0,0,1,101,0,0,0,444
0,0,0,1,101,0,0,0,1885
0,0,0,1,101,0,0,0,266
0,0,0,1,101,0,0,0,544
0,0,0,1,101,0,0,0,63
0,0,0,1,101,0,0,0,184
0,0,0,1,101,0,0,0,1088
0,0,0,1,101,0,0,0,496
0,0,0,1,101,0,0,0,538
0,0,0,1,101,0,0,0,1589
0,0,0,1,101,0,0,0,657
0,0,0,1,101,0,0,0,45
0,0,0,1,101,0,0,0,325
0,0,0,1,101,0,0,0,2509
0,0,0,1,101,0,0,0,431
0,0,0,1,101,0,0,0,3639
0,0,0,1,101,0,0,0,256
0,0,0,1,101,0,0,0,598
0,0,0,1,101,0,0,0,1332
0,0,0,1,101,0,0,0,249
0,0,0,1,101,0,0,0,347
0,0,0,1,101,0,0,0,831
0,0,0,1,101,0,0,0,767
0,0,0,1,101,0,0,0,847
0,0,0,1,101,0,0,0,538
0,0,0,1,101,0,0,0,2439
0,0,0,1,101,0,0,0,435
0,0,0,1,101,0,0,0,156
0,0,0,1,101,0,0,0,764
0,0,0,1,101,0,0,0,143
0,0,0,1,101,0,0,0,114
0,0,0,1,101,0,0,0,735
0,0,0,1,101,0,0,0,248
0,0,0,1,101,0,0,0,77
0,0,0,1,101,0,0,0,68
0,0,0,1,101,0,0,0,241
0,0,0,1,101,0,0,0,197
0,0,0,1,101,0,0,0,55
0,0,0,1,101,0,0,0,282
0,0,0,1,101,0,0,0,512
0,0,0,1,101,0,0,0,126
0,0,0,1,101,0,0,0,209
0,0,0,1,101,0,0,0,256
0,0,0,1,101,0,0,0,98
0,0,0,1,101,0,0,0,207
0,0,0,1,101,0,0,0,136
0,0,0,1,101,0,0,0,1079
0,0,0,1,101,0,0,0,237
0,0,0,1,101,0,0,0,4984
0,0,0,1,101,0,0,0,50
0,0,0,1,101,0,0,0,90
0,0,0,1,101,0,0,0,85
0,0,0,1,101,0,0,0,36
0,0,0,1,101,0,0,0,25
0,0,0,1,101,0,0,0,918
0,0,0,1,101,0,0,0,37
0,0,0,1,101,0,0,0,77
0,0,0,1,101,0,0,0,36
0,0,0,1,101,0,0,0,110
0,0,0,1,101,0,0,0,150
0,0,0,1,101,0,0,0,26
0,0,0,1,101,0,0,0,37
0,0,0,1,101,0,0,0,30
0,0,0,1,101,0,0,0,5711
0,0,0,1,101,0,0,0,1325
0,0,0,1,101,0,0,0,114
0,0,0,1,101,0,0,0,1636
0,0,0,1,101,0,0,0,315
0,0,0,1,101,0,0,0,1779
0,0,0,1,101,0,0,0,46
0,0,0,1,101,0,0,0,106
0,0,0,1,101,0,0,0,122
0,0,0,1,101,0,0,0,32
0,0,0,1,101,0,0,0,1364
0,0,0,2,100,0,0,0,137
0,0,0,1,101,0,0,0,61
0,0,0,1,101,0,0,0,68
0,0,0,1,101,0,0,0,6
0,0,0,1,101,0,0,0,147
0,0,0,1,101,0,0,0,17
0,0,0,1,101,0,0,0,78
0,0,0,1,101,0,0,0,58
0,0,0,1,101,0,0,0,96
0,0,0,1,101,0,0,0,231
0,0,0,1,101,0,0,0,10
0,0,0,1,101,0,0,0,163
0,0,0,1,101,0,0,0,19
0,0,0,1,101,0,0,0,36
0,0,0,1,101,0,0,0,13
0,0,0,1,101,0,0,0,842
0,0,0,1,101,0,0,0,395
0,0,0,1,101,0,0,0,295
0,0,0,1,101,0,0,0,220
0,0,0,1,101,0,0,0,697
0,0,0,1,101,0,0,0,359
0,0,0,1,101,0,0,0,134
0,0,0,1,101,0,0,0,558
0,0,0,1,101,0,0,0,1868
0,0,0,1,101,0,0,0,286
0,0,0,1,101,0,0,0,291
0,0,0,1,101,0,0,0,695
0,0,0,1,101,0,0,0,139
0,0,0,1,101,0,0,0,304
0,0,0,1,101,0,0,0,59
0,0,0,1,101,0,0,0,584
0,0,0,1,101,0,0,0,501
0,0,0,1,101,0,0,0,4380
0,0,0,1,101,0,0,0,509
0,0,0,1,101,0,0,0,529
0,0,0,1,101,0,0,0,2364
0,0,0,1,101,0,0,0,1782
0,0,0,1,101,0,0,0,372
0,0,0,1,101,0,0,0,573
0,0,0,1,101,0,0,0,397
0,0,0,1,101,0,0,0,293
0,0,0,1,101,0,0,0,1469
0,0,0,1,101,0,0,0,406
0,0,0,1,101,0,0,0,93
0,0,0,1,101,0,0,0,628
0,0,0,1,101,0,0,0,119
0,0,0,1,101,0,0,0,22
0,0,0,1,101,0,0,0,2005
0,0,0,1,101,0,0,0,8807
0,0,0,1,101,0,0,0,827
0,0,0,1,101,0,0,0,1547
0,0,0,1,101,0,0,0,1190
0,0,0,1,101,0,0,0,721
0,0,0,1,101,0,0,0,488
0,0,0,1,101,0,0,0,721
0,0,0,1,101,0,0,0,265
0,0,0,1,101,0,0,0,47
0,0,0,1,101,0,0,0,278
0,0,0,1,101,0,0,0,374
0,0,0,1,101,0,0,0,347
0,0,0,1,101,0,0,0,446
0,0,0,1,101,0,0,0,5264
0,0,0,1,101,0,0,0,1091
0,0,0,1,101,0,0,0,76
0,0,0,1,101,0,0,0,643
0,0,0,1,101,0,0,0,165
0,0,0,1,101,0,0,0,758
0,0,0,1,101,0,0,0,245
0,0,0,1,101,0,0,0,182
0,0,0,1,101,0,0,0,1183
0,0,0,1,101,0,0,0,158
0,0,0,1,101,0,0,0,143
0,0,0,1,101,0,0,0,370
0,0,0,1,101,0,0,0,1108
0,0,0,1,101,0,0,0,738
0,0,0,1,101,0,0,0,234
0,0,0,1,101,0,0,0,1936
0,0,0,1,101,0,0,0,801
0,0,0,1,101,0,0,0,708
0,0,0,1,101,0,0,0,1567
0,0,0,1,101,0,0,0,232
0,0,0,1,101,0,0,0,573
0,0,0,1,101,0,0,0,205
0,0,0,1,101,0,0,0,1053
0,0,0,1,101,0,0,0,1254
0,0,0,1,101,0,0,0,44
0,0,0,1,101,0,0,0,88
0,0,0,1,101,0,0,0,117
0,0,0,1,101,0,0,0,542
0,0,0,1,101,0,0,0,1289
0,0,0,1,101,0,0,0,194
0,0,0,1,101,0,0,0,291
0,0,0,1,101,0,0,0,352
0,0,0,1,101,0,0,0,380
0,0,0,1,101,0,0,0,401
0,0,0,1,101,0,0,0,770
0,0,0,1,101,0,0,0,4083
0,0,0,1,101,0,0,0,744
0,0,0,1,101,0,0,0,1016
0,0,0,1,101,0,0,0,1006
0,0,0,1,101,0,0,0,226
0,0,0,1,101,0,0,0,478
0,0,0,1,101,0,0,0,520
0,0,0,1,101,0,0,0,370
0,0,0,1,101,0,0,0,509
0,0,0,1,101,0,0,0,888
0,0,0,1,101,0,0,0,43
0,0,0,1,101,0,0,0,369
0,0,0,1,101,0,0,0,160
0,0,0,1,101,0,0,0,672
0,0,0,1,101,0,0,0,177
0,0,0,1,101,0,0,0,249
0,0,0,1,101,0,0,0,160
0,0,0,1,101,0,0,0,388
0,0,0,1,101,0,0,0,731
0,0,0,1,101,0,0,0,96
0,0,0,1,101,0,0,0,290
0,0,0,1,101,0,0,0,208
0,0,0,1,101,0,0,0,189
0,0,0,1,101,0,0,0,362
0,0,0,1,101,0,0,0,330
0,0,0,1,101,0,0,0,427
0,0,0,1,101,0,0,0,459
0,0,0,1,101,0,0,0,4798
0,0,0,1,101,0,0,0,62
0,0,0,1,101,0,0,0,2412
0,0,0,1,101,0,0,0,168
0,0,0,1,101,0,0,0,70
0,0,0,1,101,0,0,0,163
0,0,0,1,101,0,0,0,178
0,0,0,1,101,0,0,0,893
0,0,0,1,101,0,0,0,640
0,0,0,1,101,0,0,0,85
0,0,0,1,101,0,0,0,372
0,0,0,1,101,0,0,0,459
0,0,0,1,101,0,0,0,450
0,0,0,1,101,0,0,0,56
0,0,0,1,101,0,0,0,277
0,0,0,1,101,0,0,0,455
0,0,0,1,101,0,0,0,148
0,0,0,1,101,0,0,0,112
0,0,0,1,101,0,0,0,414
0,0,0,1,101,0,0,0,132
0,0,0,1,101,0,0,0,285
0,0,0,1,101,0,0,0,2126
0,0,0,1,101,0,0,0,166
0,0,0,1,101,0,0,0,132
0,0,0,1,101,0,0,0,245
0,0,0,1,101,0,0,0,281
0,0,0,1,101,0,0,0,1011
0,0,0,1,101,0,0,0,446
0,0,0,1,101,0,0,0,1270
0,0,0,1,101,0,0,0,431
0,0,0,1,101,0,0,0,190
0,0,0,1,101,0,0,0,302
0,0,0,1,101,0,0,0,134
0,0,0,1,101,0,0,0,564
0,0,0,1,101,0,0,0,250
0,0,0,1,101,0,0,0,231
0,0,0,1,101,0,0,0,2289
0,0,0,1,101,0,0,0,251
0,0,0,1,101,0,0,0,645
0,0,0,1,101,0,0,0,179
0,0,0,1,101,0,0,0,478
0,0,0,1,101,0,0,0,737
0,0,0,1,101,0,0,0,250
0,0,0,1,101,0,0,0,193
0,0,0,1,101,0,0,0,455
0,0,0,1,101,0,0,0,530
0,0,0,1,101,0,0,0,73
0,0,0,1,101,0,0,0,223
0,0,0,1,101,0,0,0,372
0,0,0,1,101,0,0,0,85
0,0,0,1,101,0,0,0,163
0,0,0,1,101,0,0,0,84
0,0,0,1,101,0,0,0,247
0,0,0,1,101,0,0,0,300
0,0,0,1,101,0,0,0,1914
0,0,0,1,101,0,0,0,405
0,0,0,1,101,0,0,0,332
0,0,0,1,101,0,0,0,74
0,0,0,1,101,0,0,0,750
0,0,0,1,101,0,0,0,106
0,0,0,1,101,0,0,0,1447
0,0,0,1,101,0,0,0,187
0,0,0,1,101,0,0,0,524
0,0,0,1,101,0,0,0,353
0,0,0,1,101,0,0,0,4484
0,0,0,1,101,0,0,0,651
0,0,0,1,101,0,0,0,21
0,0,0,1,101,0,0,0,1374
0,0,0,1,101,0,0,0,269
0,0,0,1,101,0,0,0,163
0,0,0,1,101,0,0,0,255
0,0,0,1,101,0,0,0,219
0,0,0,1,101,0,0,0,108
0,0,0,1,101,0,0,0,564
0,0,0,1,101,0,0,0,645
0,0,0,1,101,0,0,0,240
0,0,0,1,101,0,0,0,989
0,0,0,1,101,0,0,0,266
0,0,0,1,101,0,0,0,393
0,0,0,1,101,0,0,0,35
0,0,0,1,101,0,0,0,383
0,0,0,1,101,0,0,0,64
0,0,0,1,101,0,0,0,2234
0,0,0,1,101,0,0,0,144
0,0,0,1,101,0,0,0,66
0,0,0,1,101,0,0,0,236
0,0,0,1,101,0,0,0,939
0,0,0,1,101,0,0,0,442
0,0,0,1,101,0,0,0,79
0,0,0,1,101,0,0,0,168
0,0,0,1,101,0,0,0,129
0,0,0,1,101,0,0,0,759
0,0,0,1,101,0,0,0,183
0,0,0,1,101,0,0,0,708
0,0,0,1,101,0,0,0,125
0,0,0,1,101,0,0,0,298
0,0,0,1,101,0,0,0,16
0,0,0,1,101,0,0,0,1129
0,0,0,1,101,0,0,0,14
0,0,0,1,101,0,0,0,485
0,0,0,1,101,0,0,0,1523
0,0,0,1,101,0,0,0,405
0,0,0,1,101,0,0,0,17
0,0,0,1,101,0,0,0,859
0,0,0,1,101,0,0,0,244
0,0,0,1,101,0,0,0,368
0,0,0,1,101,0,0,0,616
0,0,0,1,101,0,0,0,231
0,0,0,1,101,0,0,0,510
0,0,0,1,101,0,0,0,404
0,0,0,1,101,0,0,0,368
0,0,0,1,101,0,0,0,187
0,0,0,1,101,0,0,0,481
0,0,0,1,101,0,0,0,338
0,0,0,1,101,0,0,0,74
0,0,0,1,101,0,0,0,242
0,0,0,1,101,0,0,0,319
0,0,0,1,101,0,0,0,97
0,0,0,1,101,0,0,0,100
0,0,0,1,101,0,0,0,85
0,0,0,1,101,0,0,0,166
0,0,0,1,101,0,0,0,13
0,0,0,1,101,0,0,0,1375
0,0,0,1,101,0,0,0,363
0,0,0,1,101,0,0,0,191
0,0,0,1,101,0,0,0,274
0,0,0,1,101,0,0,0,66
0,0,0,1,101,0,0,0,657
0,0,0,1,101,0,0,0,90
0,0,0,1,101,0,0,0,1265
0,0,0,1,101,0,0,0,194
0,0,0,1,101,0,0,0,125
0,0,0,1,101,0,0,0,1204
0,0,0,1,101,0,0,0,4229
0,0,0,1,101,0,0,0,923
0,0,0,1,101,0,0,0,451
0,0,0,1,101,0,0,0,982
0,0,0,1,101,0,0,0,132
0,0,0,1,101,0,0,0,262
0,0,0,1,101,0,0,0,1762
0,0,0,1,101,0,0,0,1722
0,0,0,1,101,0,0,0,207
0,0,0,1,101,0,0,0,172
0,0,0,1,101,0,0,0,998
0,0,0,1,101,0,0,0,625
0,0,0,1,101,0,0,0,1799
0,0,0,1,101,0,0,0,853
0,0,0,1,101,0,0,0,86
0,0,0,1,101,0,0,0,322
0,0,0,1,101,0,0,0,111
0,0,0,1,101,0,0,0,775
0,0,0,1,101,0,0,0,460
0,0,0,1,101,0,0,0,107
0,0,0,1,101,0,0,0,307
0,0,0,1,101,0,0,0,146
0,0,0,1,101,0,0,0,125
0,0,0,1,101,0,0,0,46
0,0,0,1,101,0,0,0,826
0,0,0,1,101,0,0,0,72
0,0,0,1,101,0,0,0,78
0,0,0,1,101,0,0,0,774
0,0,0,1,101,0,0,0,693
0,0,0,1,101,0,0,0,280
0,0,0,1,101,0,0,0,161
0,0,0,1,101,0,0,0,449
0,0,0,1,101,0,0,0,459
0,0,0,1,101,0,0,0,387
0,0,0,1,101,0,0,0,909
0,0,0,1,101,0,0,0,47
0,0,0,1,101,0,0,0,72
0,0,0,1,101,0,0,0,293
0,0,0,1,101,0,0,0,664
0,0,0,1,101,0,0,0,590
0,0,0,1,101,0,0,0,106
0,0,0,1,101,0,0,0,111
0,0,0,1,101,0,0,0,610
0,0,0,1,101,0,0,0,833
0,0,0,1,101,0,0,0,354
0,0,0,1,101,0,0,0,519
0,0,0,1,101,0,0,0,402
0,0,0,1,101,0,0,0,395
0,0,0,1,101,0,0,0,275
0,0,0,1,101,0,0,0,151
0,0,0,1,101,0,0,0,212
0,0,0,1,101,0,0,0,745
0,0,0,1,101,0,0,0,410
0,0,0,1,101,0,0,0,176
0,0,0,1,101,0,0,0,269
0,0,0,1,101,0,0,0,651
0,0,0,1,101,0,0,0,201
0,0,0,1,101,0,0,0,385
0,0,0,1,101,0,0,0,529
0,0,0,1,101,0,0,0,1360
0,0,0,1,101,0,0,0,557
0,0,0,1,101,0,0,0,399
0,0,0,1,101,0,0,0,668
0,0,0,1,101,0,0,0,290
0,0,0,1,101,0,0,0,478
0,0,0,1,101,0,0,0,143
0,0,0,1,101,0,0,0,252
0,0,0,1,101,0,0,0,291
0,0,0,1,101,0,0,0,168
0,0,0,1,101,0,0,0,224
0,0,0,1,101,0,0,0,283
0,0,0,1,101,0,0,0,242
0,0,0,1,101,0,0,0,368
0,0,0,1,101,0,0,0,389
0,0,0,1,101,0,0,0,398
0,0,0,1,101,0,0,0,91
0,0,0,1,101,0,0,0,167
0,0,0,1,101,0,0,0,638
0,0,0,1,101,0,0,0,289
0,0,0,1,101,0,0,0,1118
0,0,0,1,101,0,0,0,276
0,0,0,1,101,0,0,0,109
0,0,0,1,101,0,0,0,198
0,0,0,1,101,0,0,0,420
0,0,0,1,101,0,0,0,6
0,0,0,1,101,0,0,0,400
0,0,0,1,101,0,0,0,1096
0,0,0,1,101,0,0,0,504
0,0,0,1,101,0,0,0,856
0,0,0,1,101,0,0,0,1310
0,0,0,1,101,0,0,0,179
0,0,0,1,101,0,0,0,14
0,0,0,1,101,0,0,0,266
0,0,0,1,101,0,0,0,871
0,0,0,1,101,0,0,0,257
0,0,0,1,101,0,0,0,27
0,0,0,1,101,0,0,0,263
0,0,0,1,101,0,0,0,36
0,0,0,1,101,0,0,0,1483
0,0,0,1,101,0,0,0,71
0,0,0,1,101,0,0,0,116
0,0,0,1,101,0,0,0,34
0,0,0,1,101,0,0,0,261
0,0,0,1,101,0,0,0,221
0,0,0,1,101,0,0,0,194
0,0,0,1,101,0,0,0,148
0,0,0,1,101,0,0,0,184
0,0,0,1,101,0,0,0,154
0,0,0,1,101,0,0,0,137
0,0,0,1,101,0,0,0,284
0,0,0,1,101,0,0,0,399
0,0,0,1,101,0,0,0,115
0,0,0,1,101,0,0,0,216
0,0,0,1,101,0,0,0,166
0,0,0,1,101,0,0,0,1219
0,0,0,1,101,0,0,0,116
0,0,0,1,101,0,0,0,474
0,0,0,1,101,0,0,0,242
0,0,0,1,101,0,0,0,290
0,0,0,1,101,0,0,0,250
0,0,0,1,101,0,0,0,256
0,0,0,1,101,0,0,0,184
0,0,0,1,101,0,0,0,517
0,0,0,1,101,0,0,0,485
0,0,0,1,101,0,0,0,186
0,0,0,1,101,0,0,0,302
0,0,0,1,101,0,0,0,386
0,0,0,1,101,0,0,0,119
0,0,0,1,101,0,0,0,516
0,0,0,1,101,0,0,0,15
0,0,0,1,101,0,0,0,183
0,0,0,1,101,0,0,0,101
0,0,0,1,101,0,0,0,2250
0,0,0,1,101,0,0,0,142
0,0,0,1,101,0,0,0,137
0,0,0,1,101,0,0,0,358
0,0,0,1,101,0,0,0,238
0,0,0,1,101,0,0,0,493
0,0,0,1,101,0,0,0,337
0,0,0,1,101,0,0,0,706
0,0,0,1,101,0,0,0,661
0,0,0,1,101,0,0,0,786
0,0,0,1,101,0,0,0,68
0,0,0,1,101,0,0,0,612
0,0,0,1,101,0,0,0,12
0,0,0,1,101,0,0,0,201
0,0,0,1,101,0,0,0,95
0,0,0,1,101,0,0,0,298
0,0,0,1,101,0,0,0,98
0,0,0,1,101,0,0,0,156
0,0,0,1,101,0,0,0,89
0,0,0,1,101,0,0,0,3386
0,0,0,1,101,0,0,0,665
0,0,0,1,101,0,0,0,82
0,0,0,1,101,0,0,0,52
0,0,0,1,101,0,0,0,241
0,0,0,1,101,0,0,0,109
0,0,0,1,101,0,0,0,231
0,0,0,1,101,0,0,0,70
0,0,0,1,101,0,0,0,391
0,0,0,1,101,0,0,0,730
0,0,0,1,101,0,0,0,418
0,0,0,1,101,0,0,0,21
0,0,0,1,101,0,0,0,261
0,0,0,1,101,0,0,0,78
0,0,0,1,101,0,0,0,400
0,0,0,1,101,0,0,0,229
0,0,0,1,101,0,0,0,187
0,0,0,1,101,0,0,0,267
0,0,0,1,101,0,0,0,233
0,0,0,1,101,0,0,0,71
0,0,0,1,101,0,0,0,404
0,0,0,1,101,0,0,0,154
0,0,0,1,101,0,0,0,167
0,0,0,1,101,0,0,0,120
0,0,0,1,101,0,0,0,746
0,0,0,1,101,0,0,0,201
0,0,0,1,101,0,0,0,94
0,0,0,1,101,0,0,0,785
0,0,0,1,101,0,0,0,426
0,0,0,1,101,0,0,0,658
0,0,0,1,101,0,0,0,2706
0,0,0,1,101,0,0,0,131
0,0,0,1,101,0,0,0,214
0,0,0,1,101,0,0,0,3573
0,0,0,1,101,0,0,0,227
0,0,0,1,101,0,0,0,101
0,0,0,1,101,0,0,0,227
0,0,0,1,101,0,0,0,512
0,0,0,1,101,0,0,0,74
0,0,0,1,101,0,0,0,154
0,0,0,1,101,0,0,0,1052
0,0,0,1,101,0,0,0,129
0,0,0,1,101,0,0,0,99
0,0,0,1,101,0,0,0,1766
0,0,0,1,101,0,0,0,192
0,0,0,1,101,0,0,0,411
0,0,0,1,101,0,0,0,336
0,0,0,1,101,0,0,0,1448
0,0,0,1,101,0,0,0,512
0,0,0,1,101,0,0,0,188
0,0,0,1,101,0,0,0,526
0,0,0,1,101,0,0,0,494
0,0,0,1,101,0,0,0,816
0,0,0,1,101,0,0,0,945
0,0,0,1,101,0,0,0,278
0,0,0,1,101,0,0,0,86
0,0,0,1,101,0,0,0,852
0,0,0,1,101,0,0,0,751
0,0,0,1,101,0,0,0,503
0,0,0,1,101,0,0,0,384
0,0,0,1,101,0,0,0,401
0,0,0,1,101,0,0,0,18
0,0,0,1,101,0,0,0,91
0,0,0,1,101,0,0,0,308
0,0,0,1,101,0,0,0,2711
0,0,0,1,101,0,0,0,393
0,0,0,1,101,0,0,0,207
0,0,0,1,101,0,0,0,503
0,0,0,1,101,0,0,0,40
0,0,0,1,101,0,0,0,1181
0,0,0,1,101,0,0,0,767
0,0,0,1,101,0,0,0,528
0,0,0,1,101,0,0,0,1338
0,0,0,1,101,0,0,0,812
0,0,0,1,101,0,0,0,415
0,0,0,1,101,0,0,0,251
0,0,0,1,101,0,0,0,1027
0,0,0,1,101,0,0,0,341
0,0,0,1,101,0,0,0,473
0,0,0,1,101,0,0,0,569
0,0,0,1,101,0,0,0,596
0,0,0,1,101,0,0,0,510
0,0,0,1,101,0,0,0,654
0,0,0,1,101,0,0,0,1085
0,0,0,1,101,0,0,0,126
0,0,0,1,101,0,0,0,292
0,0,0,1,101,0,0,0,295
0,0,0,1,101,0,0,0,1075
0,0,0,1,101,0,0,0,383
0,0,0,1,101,0,0,0,286
0,0,0,1,101,0,0,0,610
0,0,0,1,101,0,0,0,60
0,0,0,1,101,0,0,0,904
0,0,0,1,101,0,0,0,889
0,0,0,1,101,0,0,0,1983
0,0,0,1,101,0,0,0,696
0,0,0,1,101,0,0,0,108
0,0,0,1,101,0,0,0,234
0,0,0,1,101,0,0,0,127
0,0,0,1,101,0,0,0,158
0,0,0,1,101,0,0,0,407
0,0,0,1,101,0,0,0,480
0,0,0,1,101,0,0,0,655
0,0,0,1,101,0,0,0,849
0,0,0,1,101,0,0,0,3344
0,0,0,1,101,0,0,0,437
0,0,0,1,101,0,0,0,1534
0,0,0,1,101,0,0,0,4139
0,0,0,1,101,0,0,0,2265
0,0,0,1,101,0,0,0,1288
0,0,0,1,101,0,0,0,1519
0,0,0,1,101,0,0,0,1565
0,0,0,1,101,0,0,0,1280
0,0,0,1,101,0,0,0,532
0,0,0,1,101,0,0,0,365
0,0,0,1,101,0,0,0,860
0,0,0,1,101,0,0,0,25
0,0,0,1,101,0,0,0,590
0,0,0,1,101,0,0,0,229
0,0,0,1,101,0,0,0,330
0,0,0,1,101,0,0,0,89
0,0,0,1,101,0,0,0,1467
0,0,0,1,101,0,0,0,429
0,0,0,1,101,0,0,0,2014
0,0,0,1,101,0,0,0,1256
0,0,0,1,101,0,0,0,645
0,0,0,1,101,0,0,0,1326
0,0,0,1,101,0,0,0,248
0,0,0,1,101,0,0,0,588
0,0,0,1,101,0,0,0,533
0,0,0,1,101,0,0,0,179
0,0,0,1,101,0,0,0,150
0,0,0,1,101,0,0,0,189
0,0,0,1,101,0,0,0,603
0,0,0,1,101,0,0,0,114
0,0,0,1,101,0,0,0,113
0,0,0,1,101,0,0,0,112
0,0,0,1,101,0,0,0,1133
0,0,0,1,101,0,0,0,461
0,0,0,1,101,0,0,0,884
0,0,0,1,101,0,0,0,356
0,0,0,1,101,0,0,0,783
0,0,0,1,101,0,0,0,463
0,0,0,1,101,0,0,0,1462
0,0,0,1,101,0,0,0,876
0,0,0,1,101,0,0,0,305
0,0,0,1,101,0,0,0,513
0,0,0,1,101,0,0,0,692
0,0,0,1,101,0,0,0,130
0,0,0,1,101,0,0,0,490
0,0,0,1,101,0,0,0,205
0,0,0,1,101,0,0,0,340
0,0,0,1,101,0,0,0,778
0,0,0,1,101,0,0,0,416
0,0,0,1,101,0,0,0,342
0,0,0,1,101,0,0,0,569
0,0,0,1,101,0,0,0,131
0,0,0,1,101,0,0,0,268
0,0,0,1,101,0,0,0,678
0,0,0,1,101,0,0,0,407
0,0,0,1,101,0,0,0,437
0,0,0,1,101,0,0,0,2854
0,0,0,1,101,0,0,0,521
0,0,0,1,101,0,0,0,334
0,0,0,1,101,0,0,0,1405
0,0,0,1,101,0,0,0,242
0,0,0,1,101,0,0,0,1946
0,0,0,1,101,0,0,0,535
0,0,0,1,101,0,0,0,1462
0,0,0,1,101,0,0,0,3964
0,0,0,1,101,0,0,0,77
0,0,0,1,101,0,0,0,249
0,0,0,1,101,0,0,0,1752
0,0,0,1,101,0,0,0,1096
0,0,0,1,101,0,0,0,480
0,0,0,1,101,0,0,0,177
0,0,0,1,101,0,0,0,628
0,0,0,1,101,0,0,0,396
0,0,0,1,101,0,0,0,560
0,0,0,1,101,0,0,0,49
0,0,0,1,101,0,0,0,82
0,0,0,1,101,0,0,0,133
0,0,0,1,101,0,0,0,211
0,0,0,1,101,0,0,0,123
0,0,0,1,101,0,0,0,273
0,0,0,1,101,0,0,0,185
0,0,0,1,101,0,0,0,653
0,0,0,1,101,0,0,0,1214
0,0,0,1,101,0,0,0,762
0,0,0,1,101,0,0,0,7206
0,0,0,1,101,0,0,0,45
0,0,0,1,101,0,0,0,243
0,0,0,1,101,0,0,0,585
0,0,0,1,101,0,0,0,1691
0,0,0,1,101,0,0,0,302
0,0,0,1,101,0,0,0,385
0,0,0,1,101,0,0,0,437
0,0,0,1,101,0,0,0,211
0,0,0,1,101,0,0,0,419
0,0,0,1,101,0,0,0,385
0,0,0,1,101,0,0,0,612
0,0,0,1,101,0,0,0,65
0,0,0,1,101,0,0,0,284
0,0,0,1,101,0,0,0,281
0,0,0,1,101,0,0,0,312
0,0,0,1,101,0,0,0,40
0,0,0,1,101,0,0,0,356
0,0,0,1,101,0,0,0,2733
0,0,0,1,101,0,0,0,434
0,0,0,1,101,0,0,0,212
0,0,0,1,101,0,0,0,292
0,0,0,1,101,0,0,0,44
0,0,0,1,101,0,0,0,317
0,0,0,1,101,0,0,0,390
0,0,0,1,101,0,0,0,48
0,0,0,1,101,0,0,0,485
0,0,0,1,101,0,0,0,31
0,0,0,1,101,0,0,0,591
0,0,0,1,101,0,0,0,417
0,0,0,1,101,0,0,0,325
0,0,0,1,101,0,0,0,1150
0,0,0,1,101,0,0,0,100
0,0,0,1,101,0,0,0,219
0,0,0,1,101,0,0,0,710
0,0,0,1,101,0,0,0,1382
0,0,0,1,101,0,0,0,300
0,0,0,1,101,0,0,0,481
0,0,0,1,101,0,0,0,154
0,0,0,1,101,0,0,0,280
0,0,0,1,101,0,0,0,491
0,0,0,1,101,0,0,0,292
0,0,0,1,101,0,0,0,780
0,0,0,1,101,0,0,0,2762
0,0,0,1,101,0,0,0,13
0,0,0,1,101,0,0,0,1178
0,0,0,1,101,0,0,0,815
0,0,0,1,101,0,0,0,443
0,0,0,1,101,0,0,0,450
0,0,0,1,101,0,0,0,21
0,0,0,1,101,0,0,0,133
0,0,0,1,101,0,0,0,290
0,0,0,1,101,0,0,0,868
0,0,0,1,101,0,0,0,153
0,0,0,1,101,0,0,0,236
0,0,0,1,101,0,0,0,600
0,0,0,1,101,0,0,0,75
0,0,0,1,101,0,0,0,104
0,0,0,1,101,0,0,0,941
0,0,0,1,101,0,0,0,287
0,0,0,1,101,0,0,0,659
0,0,0,1,101,0,0,0,300
0,0,0,1,101,0,0,0,337
0,0,0,1,101,0,0,0,1157
0,0,0,1,101,0,0,0,132
0,0,0,1,101,0,0,0,74
0,0,0,1,101,0,0,0,162
0,0,0,1,101,0,0,0,231
0,0,0,1,101,0,0,0,493
0,0,0,1,101,0,0,0,214
0,0,0,1,101,0,0,0,112
0,0,0,1,101,0,0,0,103
0,0,0,1,101,0,0,0,288
0,0,0,1,101,0,0,0,93
0,0,0,1,101,0,0,0,1357
0,0,0,1,101,0,0,0,206
0,0,0,1,101,0,0,0,154
0,0,0,1,101,0,0,0,1057
0,0,0,1,101,0,0,0,171
0,0,0,1,101,0,0,0,1186
0,0,0,1,101,0,0,0,141
0,0,0,1,101,0,0,0,1144
0,0,0,1,101,0,0,0,2068
0,0,0,1,101,0,0,0,653
0,0,0,1,101,0,0,0,243
0,0,0,1,101,0,0,0,872
0,0,0,1,101,0,0,0,5116
0,0,0,1,101,0,0,0,109
0,0,0,1,101,0,0,0,132
0,0,0,1,101,0,0,0,79
0,0,0,1,101,0,0,0,192
0,0,0,1,101,0,0,0,209
0,0,0,1,101,0,0,0,88
0,0,0,1,101,0,0,0,1548
0,0,0,1,101,0,0,0,1
0,0,0,1,101,0,0,0,151
0,0,0,1,101,0,0,0,211
0,0,0,1,101,0,0,0,42
0,0,0,1,101,0,0,0,66
0,0,0,1,101,0,0,0,201
0,0,0,1,101,0,0,0,77
0,0,0,1,101,0,0,0,683
0,0,0,1,101,0,0,0,786
0,0,0,1,101,0,0,0,91
0,0,0,1,101,0,0,0,691
0,0,0,1,101,0,0,0,758
0,0,0,1,101,0,0,0,2774
0,0,0,1,101,0,0,0,191
0,0,0,1,101,0,0,0,419
0,0,0,1,101,0,0,0,105
0,0,0,1,101,0,0,0,41
0,0,0,1,101,0,0,0,143
0,0,0,1,101,0,0,0,257
0,0,0,1,101,0,0,0,423
0,0,0,1,101,0,0,0,199
0,0,0,1,101,0,0,0,162
0,0,0,1,101,0,0,0,617
0,0,0,1,101,0,0,0,1290
0,0,0,1,101,0,0,0,840
0,0,0,1,101,0,0,0,426
0,0,0,1,101,0,0,0,96
0,0,0,1,101,0,0,0,74
0,0,0,1,101,0,0,0,452
0,0,0,1,101,0,0,0,3013
0,0,0,1,101,0,0,0,80
0,0,0,1,101,0,0,0,437
0,0,0,1,101,0,0,0,0
0,0,0,1,101,0,0,0,685
0,0,0,1,101,0,0,0,3525
0,0,0,1,101,0,0,0,12
0,0,0,1,101,0,0,0,445
0,0,0,1,101,0,0,0,1236
0,0,0,1,101,0,0,0,420
0,0,0,1,101,0,0,0,25
0,0,0,1,101,0,0,0,365
0,0,0,1,101,0,0,0,1959
0,0,0,1,101,0,0,0,273
0,0,0,1,101,0,0,0,1707
0,0,0,1,101,0,0,0,191
0,0,0,1,101,0,0,0,183
0,0,0,1,101,0,0,0,80
0,0,0,1,101,0,0,0,121
0,0,0,1,101,0,0,0,38
0,0,0,1,101,0,0,0,600
0,0,0,1,101,0,0,0,811
0,0,0,1,101,0,0,0,57
0,0,0,1,101,0,0,0,278
0,0,0,1,101,0,0,0,54
0,0,0,1,101,0,0,0,374
0,0,0,1,101,0,0,0,43
0,0,0,1,101,0,0,0,223
0,0,0,1,101,0,0,0,86
0,0,0,1,101,0,0,0,38
0,0,0,1,101,0,0,0,180
0,0,0,1,101,0,0,0,44
0,0,0,1,101,0,0,0,54
0,0,0,1,101,0,0,0,140
0,0,0,1,101,0,0,0,507
0,0,0,1,101,0,0,0,2291
0,0,0,1,101,0,0,0,69
0,0,0,1,101,0,0,0,1334
0,0,0,1,101,0,0,0,99
0,0,0,1,101,0,0,0,1824
0,0,0,1,101,0,0,0,258
0,0,0,1,101,0,0,0,276
0,0,0,1,101,0,0,0,1037
0,0,0,1,101,0,0,0,1566
0,0,0,1,101,0,0,0,184
0,0,0,1,101,0,0,0,157
0,0,0,1,101,0,0,0,291
0,0,0,1,101,0,0,0,225
0,0,0,1,101,0,0,0,1748
0,0,0,1,101,0,0,0,741
0,0,0,1,101,0,0,0,156
0,0,0,1,101,0,0,0,114
0,0,0,1,101,0,0,0,309
0,0,0,1,101,0,0,0,422
0,0,0,1,101,0,0,0,123
0,0,0,1,101,0,0,0,219
0,0,0,1,101,0,0,0,745
0,0,0,1,101,0,0,0,903
0,0,0,1,101,0,0,0,662
0,0,0,1,101,0,0,0,879
0,0,0,1,101,0,0,0,292
0,0,0,1,101,0,0,0,149
0,0,0,1,101,0,0,0,186
0,0,0,1,101,0,0,0,231
0,0,0,1,101,0,0,0,114
0,0,0,1,101,0,0,0,287
0,0,0,1,101,0,0,0,134
0,0,0,1,101,0,0,0,730
0,0,0,1,101,0,0,0,179
0,0,0,1,101,0,0,0,176
0,0,0,1,101,0,0,0,88
0,0,0,1,101,0,0,0,75
0,0,0,1,101,0,0,0,182
0,0,0,1,101,0,0,0,309
0,0,0,1,101,0,0,0,412
0,0,0,1,101,0,0,0,935
0,0,0,1,101,0,0,0,257
0,0,0,1,101,0,0,0,20
0,0,0,1,101,0,0,0,479
0,0,0,1,101,0,0,0,545
0,0,0,1,101,0,0,0,155
0,0,0,1,101,0,0,0,313
0,0,0,1,101,0,0,0,190
0,0,0,1,101,0,0,0,557
0,0,0,1,101,0,0,0,175
0,0,0,1,101,0,0,0,180
0,0,0,1,101,0,0,0,522
0,0,0,1,101,0,0,0,177
0,0,0,1,101,0,0,0,156
0,0,0,1,101,0,0,0,446
0,0,0,1,101,0,0,0,224
0,0,0,1,101,0,0,0,78
0,0,0,1,101,0,0,0,66
0,0,0,1,101,0,0,0,119
0,0,0,1,101,0,0,0,780
0,0,0,1,101,0,0,0,227
0,0,0,1,101,0,0,0,169
0,0,0,1,101,0,0,0,37
0,0,0,1,101,0,0,0,218
0,0,0,1,101,0,0,0,136
0,0,0,1,101,0,0,0,246
0,0,0,1,101,0,0,0,2595
0,0,0,1,101,0,0,0,93
0,0,0,1,101,0,0,0,293
0,0,0,1,101,0,0,0,65
0,0,0,1,101,0,0,0,433
0,0,0,1,101,0,0,0,124
0,0,0,1,101,0,0,0,126
0,0,0,1,101,0,0,0,241
0,0,0,1,101,0,0,0,111
0,0,0,1,101,0,0,0,177
0,0,0,1,101,0,0,0,287
0,0,0,1,101,0,0,0,232
0,0,0,1,101,0,0,0,198
0,0,0,1,101,0,0,0,95
0,0,0,1,101,0,0,0,280
0,0,0,1,101,0,0,0,516
0,0,0,1,101,0,0,0,119
0,0,0,1,101,0,0,0,18
0,0,0,1,101,0,0,0,136
0,0,0,1,101,0,0,0,614
0,0,0,1,101,0,0,0,268
0,0,0,1,101,0,0,0,93
0,0,0,1,101,0,0,0,153
0,0,0,1,101,0,0,0,36
0,0,0,1,101,0,0,0,190
0,0,0,1,101,0,0,0,169
0,0,0,1,101,0,0,0,265
0,0,0,1,101,0,0,0,140
0,0,0,1,101,0,0,0,152
0,0,0,1,101,0,0,0,176
0,0,0,1,101,0,0,0,151
0,0,0,1,101,0,0,0,206
0,0,0,1,101,0,0,0,102
0,0,0,1,101,0,0,0,547
0,0,0,1,101,0,0,0,63
0,0,0,1,101,0,0,0,54
0,0,0,1,101,0,0,0,73
0,0,0,1,101,0,0,0,295
0,0,0,1,101,0,0,0,171
0,0,0,1,101,0,0,0,112
0,0,0,1,101,0,0,0,268
0,0,0,1,101,0,0,0,77
0,0,0,1,101,0,0,0,134
0,0,0,1,101,0,0,0,261
0,0,0,1,101,0,0,0,297
0,0,0,1,101,0,0,0,653
0,0,0,1,101,0,0,0,58
0,0,0,1,101,0,0,0,404
0,0,0,1,101,0,0,0,752
0,0,0,1,101,0,0,0,209
0,0,0,1,101,0,0,0,189
0,0,0,1,101,0,0,0,25
0,0,0,1,101,0,0,0,156
0,0,0,1,101,0,0,0,80
0,0,0,1,101,0,0,0,314
0,0,0,1,101,0,0,0,109
0,0,0,1,101,0,0,0,79
0,0,0,1,101,0,0,0,124
0,0,0,1,101,0,0,0,66
0,0,0,1,101,0,0,0,247
0,0,0,1,101,0,0,0,113
0,0,0,1,101,0,0,0,125
0,0,0,1,101,0,0,0,124
0,0,0,1,101,0,0,0,397
0,0,0,1,101,0,0,0,179
0,0,0,1,101,0,0,0,216
0,0,0,1,101,0,0,0,129
0,0,0,1,101,0,0,0,153
0,0,0,1,101,0,0,0,361
0,0,0,1,101,0,0,0,93
0,0,0,1,101,0,0,0,72
0,0,0,1,101,0,0,0,150
0,0,0,1,101,0,0,0,246
0,0,0,1,101,0,0,0,159
0,0,0,1,101,0,0,0,123
0,0,0,1,101,0,0,0,262
0,0,0,1,101,0,0,0,124
0,0,0,1,101,0,0,0,123
0,0,0,1,101,0,0,0,875
0,0,0,1,101,0,0,0,112
0,0,0,1,101,0,0,0,653
0,0,0,1,101,0,0,0,103
0,0,0,1,101,0,0,0,589
0,0,0,1,101,0,0,0,81
0,0,0,1,101,0,0,0,271
0,0,0,1,101,0,0,0,159
0,0,0,1,101,0,0,0,408
0,0,0,1,101,0,0,0,702
0,0,0,1,101,0,0,0,350
0,0,0,1,101,0,0,0,98
0,0,0,1,101,0,0,0,107
0,0,0,1,101,0,0,0,239
0,0,0,1,101,0,0,0,753
0,0,0,2,100,0,0,0,25
0,0,0,1,101,0,0,0,814
0,0,0,2,100,0,0,0,7876
0,0,0,1,101,0,0,0,911
0,0,0,1,101,0,0,0,3661
0,0,0,1,101,0,0,0,1491
0,0,0,1,101,0,0,0,345
0,0,0,1,101,0,0,0,103
0,0,0,1,101,0,0,0,900
0,0,0,1,101,0,0,0,609
0,0,0,1,101,0,0,0,1594
0,0,0,1,101,0,0,0,1459
0,0,0,1,101,0,0,0,166
0,0,0,1,101,0,0,0,4296
0,0,0,1,101,0,0,0,3213
0,0,0,1,101,0,0,0,1252
0,0,0,1,101,0,0,0,1688
0,0,0,1,101,0,0,0,662
0,0,0,1,101,0,0,0,1
0,0,0,1,101,0,0,0,234
0,0,0,1,101,0,0,0,1547
0,0,0,1,101,0,0,0,572
0,0,0,1,101,0,0,0,2785
0,0,0,1,101,0,0,0,28
0,0,0,2,100,0,0,0,3
0,0,0,1,101,0,0,0,2275
0,0,0,1,101,0,0,0,2188
0,0,0,1,101,0,0,0,2074
0,0,0,1,101,0,0,0,3037
0,0,0,1,101,0,0,0,6565
0,0,0,1,101,0,0,0,1128
0,0,0,1,101,0,0,0,1981
0,0,0,1,101,0,0,0,2673
0,0,0,1,101,0,0,0,778
0,0,0,1,101,0,0,0,208
0,0,0,1,101,0,0,0,1061
0,0,0,1,101,0,0,0,1180
0,0,0,1,101,0,0,0,1582
0,0,0,1,101,0,0,0,2179
0,0,0,1,101,0,0,0,127
0,0,0,1,101,0,0,0,683
0,0,0,1,101,0,0,0,109
0,0,0,1,101,0,0,0,18
0,0,0,1,101,0,0,0,337
0,0,0,1,101,0,0,0,1038
0,0,0,1,101,0,0,0,53
0,0,0,1,101,0,0,0,83
0,0,0,1,101,0,0,0,418
0,0,0,2,100,0,0,0,69
0,0,0,1,101,0,0,0,904
0,0,0,1,101,0,0,0,1132
0,0,0,1,101,0,0,0,259
0,0,0,1,101,0,0,0,2759
0,0,0,1,101,0,0,0,963
0,0,0,1,101,0,0,0,998
0,0,0,1,101,0,0,0,112
0,0,0,1,101,0,0,0,826
0,0,0,1,101,0,0,0,1078
0,0,0,1,101,0,0,0,905
0,0,0,1,101,0,0,0,707
0,0,0,1,101,0,0,0,7886
0,0,0,1,101,0,0,0,951
0,0,0,1,101,0,0,0,3623
0,0,0,1,101,0,0,0,847
0,0,0,1,101,0,0,0,658
0,0,0,1,101,0,0,0,659
0,0,0,1,101,0,0,0,727
0,0,0,1,101,0,0,0,1361
0,0,0,1,101,0,0,0,707
0,0,0,1,101,0,0,0,881
0,0,0,1,101,0,0,0,297
0,0,0,1,101,0,0,0,1228
0,0,0,1,101,0,0,0,1284
0,0,0,1,101,0,0,0,361
0,0,0,1,101,0,0,0,1357
0,0,0,1,101,0,0,0,1589
0,0,0,1,101,0,0,0,8
0,0,0,1,101,0,0,0,1120
0,0,0,1,101,0,0,0,203
0,0,0,2,100,0,0,0,1034
0,0,0,1,101,0,0,0,79
0,0,0,1,101,0,0,0,113
0,0,0,1,101,0,0,0,556
0,0,0,1,101,0,0,0,26
0,0,0,1,101,0,0,0,289
0,0,0,1,101,0,0,0,1381
0,0,0,1,101,0,0,0,959
0,0,0,1,101,0,0,0,59
0,0,0,1,101,0,0,0,67
0,0,0,1,101,0,0,0,178
0,0,0,1,101,0,0,0,78
0,0,0,1,101,0,0,0,327
0,0,0,1,101,0,0,0,87
0,0,0,1,101,0,0,0,653
0,0,0,1,101,0,0,0,208
0,0,0,1,101,0,0,0,78
0,0,0,1,101,0,0,0,37
0,0,0,1,101,0,0,0,58
0,0,0,1,101,0,0,0,251
0,0,0,1,101,0,0,0,66
0,0,0,1,101,0,0,0,188
0,0,0,1,101,0,0,0,64
0,0,0,1,101,0,0,0,1813
0,0,0,1,101,0,0,0,407
0,0,0,1,101,0,0,0,199
0,0,0,1,101,0,0,0,77
0,0,0,1,101,0,0,0,8447
0,0,0,1,101,0,0,0,545
0,0,0,1,101,0,0,0,265
0,0,0,1,101,0,0,0,104
0,0,0,1,101,0,0,0,12
0,0,0,1,101,0,0,0,81
0,0,0,1,101,0,0,0,32
0,0,0,1,101,0,0,0,152
0,0,0,1,101,0,0,0,51
0,0,0,1,101,0,0,0,429
0,0,0,1,101,0,0,0,256
0,0,0,1,101,0,0,0,270
0,0,0,1,101,0,0,0,907
0,0,0,1,101,0,0,0,228
0,0,0,1,101,0,0,0,617
0,0,0,1,101,0,0,0,525
0,0,0,1,101,0,0,0,180
0,0,0,1,101,0,0,0,185
0,0,0,1,101,0,0,0,193
0,0,0,1,101,0,0,0,536
0,0,0,1,101,0,0,0,373
0,0,0,1,101,0,0,0,228
0,0,0,1,101,0,0,0,679
0,0,0,1,101,0,0,0,368
0,0,0,1,101,0,0,0,506
0,0,0,1,101,0,0,0,363
0,0,0,1,101,0,0,0,451
0,0,0,1,101,0,0,0,457
0,0,0,1,101,0,0,0,188
0,0,0,1,101,0,0,0,222
0,0,0,1,101,0,0,0,210
0,0,0,1,101,0,0,0,399
0,0,0,1,101,0,0,0,273
0,0,0,1,101,0,0,0,238
0,0,0,1,101,0,0,0,619
0,0,0,1,101,0,0,0,230
0,0,0,1,101,0,0,0,176
0,0,0,1,101,0,0,0,466
0,0,0,1,101,0,0,0,263
0,0,0,1,101,0,0,0,288
0,0,0,1,101,0,0,0,313
0,0,0,1,101,0,0,0,2059
0,0,0,1,101,0,0,0,275
0,0,0,1,101,0,0,0,279
0,0,0,1,101,0,0,0,126
0,0,0,1,101,0,0,0,282
0,0,0,1,101,0,0,0,212
0,0,0,1,101,0,0,0,358
0,0,0,1,101,0,0,0,186
0,0,0,1,101,0,0,0,188
0,0,0,1,101,0,0,0,363
0,0,0,1,101,0,0,0,445
0,0,0,1,101,0,0,0,412
0,0,0,1,101,0,0,0,236
0,0,0,1,101,0,0,0,399
0,0,0,1,101,0,0,0,518
0,0,0,1,101,0,0,0,430
0,0,0,1,101,0,0,0,655
0,0,0,1,101,0,0,0,522
0,0,0,1,101,0,0,0,1282
0,0,0,1,101,0,0,0,362
0,0,0,1,101,0,0,0,198
0,0,0,1,101,0,0,0,316
0,0,0,1,101,0,0,0,347
0,0,0,1,101,0,0,0,592
0,0,0,1,101,0,0,0,1305
0,0,0,1,101,0,0,0,600
0,0,0,1,101,0,0,0,175
0,0,0,1,101,0,0,0,279
0,0,0,1,101,0,0,0,569
0,0,0,1,101,0,0,0,213
0,0,0,1,101,0,0,0,322
0,0,0,1,101,0,0,0,1715
0,0,0,1,101,0,0,0,223
0,0,0,1,101,0,0,0,357
0,0,0,1,101,0,0,0,408
0,0,0,1,101,0,0,0,321
0,0,0,1,101,0,0,0,205
0,0,0,1,101,0,0,0,289
0,0,0,1,101,0,0,0,226
0,0,0,1,101,0,0,0,397
0,0,0,1,101,0,0,0,904
0,0,0,1,101,0,0,0,396
0,0,0,1,101,0,0,0,366
0,0,0,1,101,0,0,0,494
0,0,0,1,101,0,0,0,316
0,0,0,1,101,0,0,0,477
0,0,0,1,101,0,0,0,305
0,0,0,1,101,0,0,0,314
0,0,0,1,101,0,0,0,310
0,0,0,1,101,0,0,0,62
0,0,0,1,101,0,0,0,184
0,0,0,1,101,0,0,0,486
0,0,0,1,101,0,0,0,120
0,0,0,1,101,0,0,0,655
0,0,0,1,101,0,0,0,168
0,0,0,1,101,0,0,0,176
0,0,0,1,101,0,0,0,33
0,0,0,1,101,0,0,0,986
0,0,0,1,101,0,0,0,75
0,0,0,1,101,0,0,0,216
0,0,0,1,101,0,0,0,46
0,0,0,1,101,0,0,0,123
0,0,0,1,101,0,0,0,771
0,0,0,1,101,0,0,0,100
0,0,0,1,101,0,0,0,366
0,0,0,1,101,0,0,0,190
0,0,0,1,101,0,0,0,249
0,0,0,1,101,0,0,0,158
0,0,0,1,101,0,0,0,64
0,0,0,1,101,0,0,0,55
0,0,0,1,101,0,0,0,177
0,0,0,1,101,0,0,0,119
0,0,0,1,101,0,0,0,12
0,0,0,1,101,0,0,0,389
0,0,0,1,101,0,0,0,135
0,0,0,1,101,0,0,0,191
0,0,0,1,101,0,0,0,326
0,0,0,1,101,0,0,0,80
0,0,0,1,101,0,0,0,4621
0,0,0,1,101,0,0,0,3
0,0,0,1,101,0,0,0,3
0,0,0,1,101,0,0,0,3
0,0,0,1,101,0,0,0,3
0,0,0,1,101,0,0,0,23
0,0,0,2,100,0,0,0,8
0,0,0,2,100,0,0,0,7339
0,0,0,1,101,0,0,0,165
0,0,0,1,101,0,0,0,896
0,0,0,1,101,0,0,0,333
0,0,0,1,101,0,0,0,101
0,0,0,1,101,0,0,0,84
0,0,0,1,101,0,0,0,139
0,0,0,1,101,0,0,0,276
0,0,0,1,101,0,0,0,194
0,0,0,1,101,0,0,0,1
0,0,0,1,101,0,0,0,1275
0,0,0,1,101,0,0,0,14
0,0,0,1,101,0,0,0,934
0,0,0,1,101,0,0,0,20
0,0,0,1,101,0,0,0,12
0,0,0,1,101,0,0,0,14
0,0,0,1,101,0,0,0,4
0,0,0,1,101,0,0,0,56
0,0,0,1,101,0,0,0,579
0,0,0,1,101,0,0,0,32
0,0,0,1,101,0,0,0,518
0,0,0,1,101,0,0,0,57
0,0,0,1,101,0,0,0,1124
0,0,0,1,101,0,0,0,964
0,0,0,1,101,0,0,0,247
0,0,0,1,101,0,0,0,337
0,0,0,1,101,0,0,0,231
0,0,0,1,101,0,0,0,62
0,0,0,1,101,0,0,0,32
0,0,0,1,101,0,0,0,70
0,0,0,1,101,0,0,0,343
0,0,0,1,101,0,0,0,52
0,0,0,1,101,0,0,0,65
0,0,0,1,101,0,0,0,442
0,0,0,1,101,0,0,0,372
0,0,0,1,101,0,0,0,440
0,0,0,1,101,0,0,0,285
0,0,0,1,101,0,0,0,519
0,0,0,1,101,0,0,0,274
0,0,0,1,101,0,0,0,243
0,0,0,1,101,0,0,0,267
0,0,0,1,101,0,0,0,119
0,0,0,1,101,0,0,0,150
0,0,0,1,101,0,0,0,275
0,0,0,1,101,0,0,0,286
0,0,0,1,101,0,0,0,130
0,0,0,1,101,0,0,0,1350
0,0,0,1,101,0,0,0,199
0,0,0,1,101,0,0,0,846
0,0,0,1,101,0,0,0,1789
0,0,0,1,101,0,0,0,1243
0,0,0,1,101,0,0,0,117
0,0,0,1,101,0,0,0,73
0,0,0,1,101,0,0,0,111
0,0,0,1,101,0,0,0,1566
0,0,0,1,101,0,0,0,525
0,0,0,1,101,0,0,0,1253
0,0,0,1,101,0,0,0,67
0,0,0,1,101,0,0,0,2598
0,0,0,1,101,0,0,0,1953
0,0,0,1,101,0,0,0,1606
0,0,0,1,101,0,0,0,1084
0,0,0,1,101,0,0,0,179
0,0,0,1,101,0,0,0,144
0,0,0,1,101,0,0,0,2629
0,0,0,1,101,0,0,0,683
0,0,0,1,101,0,0,0,293
0,0,0,1,101,0,0,0,1342
0,0,0,1,101,0,0,0,626
0,0,0,1,101,0,0,0,64
0,0,0,1,101,0,0,0,639
0,0,0,1,101,0,0,0,650
0,0,0,1,101,0,0,0,289
0,0,0,1,101,0,0,0,294
0,0,0,1,101,0,0,0,235
0,0,0,1,101,0,0,0,158
0,0,0,1,101,0,0,0,273
0,0,0,1,101,0,0,0,293
0,0,0,1,101,0,0,0,33
0,0,0,1,101,0,0,0,74
0,0,0,1,101,0,0,0,225
0,0,0,1,101,0,0,0,394
0,0,0,1,101,0,0,0,725
0,0,0,1,101,0,0,0,378
0,0,0,1,101,0,0,0,651
0,0,0,1,101,0,0,0,101
0,0,0,1,101,0,0,0,515
0,0,0,1,101,0,0,0,323
0,0,0,1,101,0,0,0,9
0,0,0,1,101,0,0,0,173
0,0,0,1,101,0,0,0,12
0,0,0,1,101,0,0,0,124
0,0,0,1,101,0,0,0,58
0,0,0,1,101,0,0,0,50
0,0,0,1,101,0,0,0,109
0,0,0,1,101,0,0,0,170
0,0,0,1,101,0,0,0,72
0,0,0,1,101,0,0,0,154
0,0,0,1,101,0,0,0,179
0,0,0,1,101,0,0,0,289
0,0,0,1,101,0,0,0,155
0,0,0,1,101,0,0,0,829
0,0,0,1,101,0,0,0,63
0,0,0,1,101,0,0,0,843
0,0,0,1,101,0,0,0,432
0,0,0,1,101,0,0,0,462
0,0,0,1,101,0,0,0,515
0,0,0,1,101,0,0,0,424
0,0,0,1,101,0,0,0,350
0,0,0,1,101,0,0,0,303
0,0,0,1,101,0,0,0,42
0,0,0,1,101,0,0,0,640
0,0,0,1,101,0,0,0,357
0,0,0,1,101,0,0,0,328
0,0,0,1,101,0,0,0,309
0,0,0,1,101,0,0,0,632
0,0,0,1,101,0,0,0,460
0,0,0,1,101,0,0,0,5310
0,0,0,1,101,0,0,0,2100
0,0,0,1,101,0,0,0,486
0,0,0,1,101,0,0,0,632
0,0,0,1,101,0,0,0,1730
0,0,0,1,101,0,0,0,325
0,0,0,1,101,0,0,0,778
0,0,0,1,101,0,0,0,455
0,0,0,1,101,0,0,0,449
0,0,0,1,101,0,0,0,895
0,0,0,1,101,0,0,0,309
0,0,0,1,101,0,0,0,276
0,0,0,1,101,0,0,0,161
0,0,0,1,101,0,0,0,152
0,0,0,1,101,0,0,0,471
0,0,0,1,101,0,0,0,367
0,0,0,1,101,0,0,0,273
0,0,0,1,101,0,0,0,94
0,0,0,1,101,0,0,0,566
0,0,0,1,101,0,0,0,100
0,0,0,1,101,0,0,0,552
0,0,0,1,101,0,0,0,221
0,0,0,1,101,0,0,0,321
0,0,0,1,101,0,0,0,128
0,0,0,1,101,0,0,0,114
0,0,0,1,101,0,0,0,61
0,0,0,1,101,0,0,0,1524
0,0,0,1,101,0,0,0,2531
0,0,0,1,101,0,0,0,1459
0,0,0,1,101,0,0,0,526
0,0,0,1,101,0,0,0,179
0,0,0,1,101,0,0,0,301
0,0,0,1,101,0,0,0,1201
0,0,0,1,101,0,0,0,291
0,0,0,1,101,0,0,0,102
0,0,0,1,101,0,0,0,1101
0,0,0,1,101,0,0,0,436
0,0,0,1,101,0,0,0,108
0,0,0,1,101,0,0,0,121
0,0,0,1,101,0,0,0,85
0,0,0,1,101,0,0,0,98
0,0,0,1,101,0,0,0,293
0,0,0,1,101,0,0,0,1271
0,0,0,1,101,0,0,0,5013
0,0,0,1,101,0,0,0,98
0,0,0,1,101,0,0,0,204
0,0,0,1,101,0,0,0,2740
0,0,0,1,101,0,0,0,548
0,0,0,1,101,0,0,0,1123
0,0,0,1,101,0,0,0,3817
0,0,0,1,101,0,0,0,984
0,0,0,1,101,0,0,0,961
0,0,0,1,101,0,0,0,1507
0,0,0,1,101,0,0,0,83
0,0,0,1,101,0,0,0,101
0,0,0,1,101,0,0,0,827
0,0,0,1,101,0,0,0,324
0,0,0,1,101,0,0,0,487
0,0,0,1,101,0,0,0,459
0,0,0,1,101,0,0,0,248
0,0,0,1,101,0,0,0,330
0,0,0,1,101,0,0,0,104
0,0,0,1,101,0,0,0,352
0,0,0,1,101,0,0,0,1471
0,0,0,1,101,0,0,0,491
0,0,0,1,101,0,0,0,440
0,0,0,1,101,0,0,0,468
0,0,0,1,101,0,0,0,528
0,0,0,1,101,0,0,0,1593
0,0,0,1,101,0,0,0,1031
0,0,0,1,101,0,0,0,420
0,0,0,1,101,0,0,0,398
0,0,0,1,101,0,0,0,244
0,0,0,1,101,0,0,0,721
0,0,0,1,101,0,0,0,333
0,0,0,1,101,0,0,0,309
0,0,0,1,101,0,0,0,279
0,0,0,1,101,0,0,0,339
0,0,0,1,101,0,0,0,1820
0,0,0,1,101,0,0,0,288
0,0,0,1,101,0,0,0,127
0,0,0,1,101,0,0,0,1472
0,0,0,1,101,0,0,0,928
0,0,0,1,101,0,0,0,755
0,0,0,1,101,0,0,0,1598
0,0,0,1,101,0,0,0,164
0,0,0,1,101,0,0,0,608
0,0,0,1,101,0,0,0,264
0,0,0,1,101,0,0,0,215
0,0,0,1,101,0,0,0,15
0,0,0,1,101,0,0,0,378
0,0,0,1,101,0,0,0,65
0,0,0,1,101,0,0,0,2424
0,0,0,1,101,0,0,0,109
0,0,0,1,101,0,0,0,73
0,0,0,1,101,0,0,0,242
0,0,0,1,101,0,0,0,278
0,0,0,1,101,0,0,0,926
0,0,0,1,101,0,0,0,98
0,0,0,1,101,0,0,0,20
0,0,0,1,101,0,0,0,459
0,0,0,1,101,0,0,0,371
0,0,0,1,101,0,0,0,294
0,0,0,1,101,0,0,0,277
0,0,0,1,101,0,0,0,238
0,0,0,1,101,0,0,0,240
0,0,0,1,101,0,0,0,493
0,0,0,1,101,0,0,0,288
0,0,0,1,101,0,0,0,128
0,0,0,1,101,0,0,0,2406
0,0,0,1,101,0,0,0,794
0,0,0,1,101,0,0,0,404
0,0,0,1,101,0,0,0,265
0,0,0,1,101,0,0,0,1760
0,0,0,1,101,0,0,0,1021
0,0,0,1,101,0,0,0,57
0,0,0,1,101,0,0,0,60
0,0,0,1,101,0,0,0,72
0,0,0,1,101,0,0,0,108
0,0,0,1,101,0,0,0,95
0,0,0,1,101,0,0,0,67
0,0,0,1,101,0,0,0,61
0,0,0,1,101,0,0,0,110
0,0,0,1,101,0,0,0,87
0,0,0,1,101,0,0,0,144
0,0,0,1,101,0,0,0,55
0,0,0,1,101,0,0,0,101
0,0,0,1,101,0,0,0,94
0,0,0,1,101,0,0,0,69
0,0,0,1,101,0,0,0,57
0,0,0,1,101,0,0,0,57
0,0,0,1,101,0,0,0,93
0,0,0,1,101,0,0,0,122
0,0,0,1,101,0,0,0,59
0,0,0,1,101,0,0,0,60
0,0,0,1,101,0,0,0,60
0,0,0,1,101,0,0,0,99
0,0,0,1,101,0,0,0,77
0,0,0,1,101,0,0,0,64
0,0,0,1,101,0,0,0,51
0,0,0,1,101,0,0,0,81
0,0,0,1,101,0,0,0,86
0,0,0,1,101,0,0,0,88
0,0,0,1,101,0,0,0,94
0,0,0,1,101,0,0,0,144
0,0,0,1,101,0,0,0,264
0,0,0,1,101,0,0,0,139
0,0,0,1,101,0,0,0,181
0,0,0,1,101,0,0,0,151
0,0,0,1,101,0,0,0,117
0,0,0,1,101,0,0,0,61
0,0,0,1,101,0,0,0,153
0,0,0,1,101,0,0,0,66
0,0,0,1,101,0,0,0,148
0,0,0,1,101,0,0,0,63
0,0,0,1,101,0,0,0,63
0,0,0,1,101,0,0,0,72
0,0,0,1,101,0,0,0,565
0,0,0,1,101,0,0,0,99
0,0,0,1,101,0,0,0,111
0,0,0,1,101,0,0,0,113
0,0,0,1,101,0,0,0,61
0,0,0,1,101,0,0,0,127
0,0,0,1,101,0,0,0,55
0,0,0,1,101,0,0,0,55
0,0,0,1,101,0,0,0,53
0,0,0,1,101,0,0,0,63
0,0,0,1,101,0,0,0,84
0,0,0,1,101,0,0,0,101
0,0,0,1,101,0,0,0,245
0,0,0,1,101,0,0,0,72
0,0,0,1,101,0,0,0,162
0,0,0,1,101,0,0,0,109
0,0,0,1,101,0,0,0,104
0,0,0,1,101,0,0,0,79
0,0,0,1,101,0,0,0,2273
0,0,0,1,101,0,0,0,199
0,0,0,1,101,0,0,0,149
0,0,0,1,101,0,0,0,79
0,0,0,1,101,0,0,0,423
0,0,0,1,101,0,0,0,441
0,0,0,1,101,0,0,0,1736
0,0,0,1,101,0,0,0,331
0,0,0,1,101,0,0,0,565
0,0,0,1,101,0,0,0,1032
0,0,0,1,101,0,0,0,623
0,0,0,1,101,0,0,0,318
0,0,0,1,101,0,0,0,11
0,0,0,1,101,0,0,0,94
0,0,0,1,101,0,0,0,1368
0,0,0,1,101,0,0,0,115
0,0,0,1,101,0,0,0,329
0,0,0,1,101,0,0,0,55
0,0,0,1,101,0,0,0,322
0,0,0,1,101,0,0,0,1219
0,0,0,1,101,0,0,0,128
0,0,0,1,101,0,0,0,61
0,0,0,1,101,0,0,0,332
0,0,0,1,101,0,0,0,1357
0,0,0,1,101,0,0,0,318
0,0,0,1,101,0,0,0,269
0,0,0,1,101,0,0,0,608
0,0,0,1,101,0,0,0,164
0,0,0,1,101,0,0,0,237
0,0,0,1,101,0,0,0,297
0,0,0,1,101,0,0,0,86
0,0,0,1,101,0,0,0,491
0,0,0,1,101,0,0,0,88
0,0,0,1,101,0,0,0,417
0,0,0,1,101,0,0,0,93
0,0,0,1,101,0,0,0,42
0,0,0,1,101,0,0,0,689
0,0,0,1,101,0,0,0,1701
0,0,0,1,101,0,0,0,521
0,0,0,1,101,0,0,0,365
0,0,0,1,101,0,0,0,419
0,0,0,1,101,0,0,0,191
0,0,0,1,101,0,0,0,249
0,0,0,1,101,0,0,0,493
0,0,0,1,101,0,0,0,125
0,0,0,1,101,0,0,0,45
0,0,0,1,101,0,0,0,20
0,0,0,1,101,0,0,0,189
0,0,0,1,101,0,0,0,31
0,0,0,1,101,0,0,0,980
2,1,1,1,18,1,0,0.0103092783505155,97
16,10,6,3,101,0,0,0,0
0,0,0,2,101,0,0,0,0
16,8,8,3,101,0,0,0,0
312,239,73,7,101,0,0,0,0
14,5,9,1,93,0,0,0,621
0,0,0,1,93,0,0,0,101
13,13,0,3,101,0,0,0,0
1,1,0,3,101,0,0,0,0
6,6,0,3,101,0,0,0,0
2,2,0,3,101,0,0,0,0
8,7,1,3,101,0,0,0,0
1,1,0,3,101,0,0,0,0
16,15,1,3,101,0,0,0,0
2,2,0,3,101,0,0,0,0
0,0,0,2,101,0,0,0,0
0,0,0,2,101,0,0,0,0
67,65,2,4,101,0,0,0,0
1,1,0,3,101,0,0,0,0
0,0,0,2,101,0,0,0,0
0,0,0,2,101,0,0,0,0
0,0,0,2,101,0,0,0,0
0,0,0,2,101,0,0,0,0
0,0,0,2,101,0,0,0,0
0,0,0,2,101,0,0,0,0
0,0,0,2,101,0,0,0,0
0,0,0,2,101,0,0,0,0
0,0,0,2,101,0,0,0,0
0,0,0,2,101,0,0,0,0
0,0,0,2,101,0,0,0,0
0,0,0,2,101,0,0,0,0
0,0,0,2,101,0,0,0,0
0,0,0,2,101,0,0,0,0
0,0,0,2,101,0,0,0,0
0,0,0,2,101,0,0,0,0
0,0,0,2,101,0,0,0,0
0,0,0,2,101,0,0,0,0
0,0,0,2,101,0,0,0,0
0,0,0,2,101,0,0,0,0
0,0,0,2,101,0,0,0,0
0,0,0,2,101,0,0,0,0
0,0,0,2,101,0,0,0,0
0,0,0,2,101,0,0,0,0
0,0,0,2,101,0,0,0,0
0,0,0,2,101,0,0,0,0
0,0,0,2,101,0,0,0,0
0,0,0,2,101,0,0,0,0
0,0,0,2,101,0,0,0,0
0,0,0,2,101,0,0,0,0
0,0,0,2,101,0,0,0,0
0,0,0,2,101,0,0,0,0
0,0,0,2,101,0,0,0,0
0,0,0,2,101,0,0,0,0
0,0,0,2,101,0,0,0,0
0,0,0,2,101,0,0,0,0
0,0,0,2,101,0,0,0,0
0,0,0,2,101,0,0,0,0
0,0,0,2,101,0,0,0,0
0,0,0,2,101,0,0,0,0
0,0,0,2,101,0,0,0,0
0,0,0,2,101,0,0,0,0
0,0,0,2,101,0,0,0,0
0,0,0,2,101,0,0,0,0
0,0,0,2,101,0,0,0,0
0,0,0,2,101,0,0,0,0
0,0,0,2,101,0,0,0,0
0,0,0,2,101,0,0,0,0
0,0,0,2,101,0,0,0,0
0,0,0,2,101,0,0,0,0
0,0,0,2,101,0,0,0,0
0,0,0,2,101,0,0,0,0
0,0,0,2,101,0,0,0,0
0,0,0,2,101,0,0,0,0
0,0,0,2,101,0,0,0,0
0,0,0,2,101,0,0,0,0
0,0,0,2,101,0,0,0,0
0,0,0,2,101,0,0,0,0
0,0,0,2,101,0,0,0,0
0,0,0,2,101,0,0,0,0
0,0,0,2,101,0,0,0,0
0,0,0,2,101,0,0,0,0
0,0,0,2,101,0,0,0,0
0,0,0,2,101,0,0,0,0
0,0,0,2,101,0,0,0,0
0,0,0,2,101,0,0,0,0
0,0,0,2,101,0,0,0,0
0,0,0,2,101,0,0,0,0
0,0,0,2,101,0,0,0,0
0,0,0,2,101,0,0,0,0
0,0,0,2,101,0,0,0,0
0,0,0,2,101,0,0,0,0
0,0,0,2,101,0,0,0,0
0,0,0,2,101,0,0,0,0
0,0,0,2,101,0,0,0,0
0,0,0,2,101,0,0,0,0
0,0,0,2,101,0,0,0,0
0,0,0,2,101,0,0,0,0
0,0,0,2,101,0,0,0,0
0,0,0,2,101,0,0,0,0
0,0,0,2,101,0,0,0,0
0,0,0,2,101,0,0,0,0
0,0,0,2,101,0,0,0,0
0,0,0,2,101,0,0,0,0
0,0,0,2,101,0,0,0,0
0,0,0,2,101,0,0,0,0
0,0,0,2,101,0,0,0,0
0,0,0,2,101,0,0,0,0
0,0,0,2,101,0,0,0,0
0,0,0,2,101,0,0,0,0
0,0,0,2,101,0,0,0,0
0,0,0,2,101,0,0,0,0
0,0,0,2,101,0,0,0,0
0,0,0,2,101,0,0,0,0
0,0,0,2,101,0,0,0,0
0,0,0,2,101,0,0,0,0
0,0,0,2,101,0,0,0,0
0,0,0,2,101,0,0,0,0
0,0,0,2,101,0,0,0,0
0,0,0,2,101,0,0,0,0
0,0,0,2,101,0,0,0,0
0,0,0,2,101,0,0,0,0
0,0,0,2,101,0,0,0,0
0,0,0,2,101,0,0,0,0
0,0,0,2,101,0,0,0,0
0,0,0,2,101,0,0,0,0
0,0,0,2,101,0,0,0,0
0,0,0,2,101,0,0,0,0
0,0,0,2,101,0,0,0,0
0,0,0,2,101,0,0,0,0
0,0,0,2,101,0,0,0,0
0,0,0,2,101,0,0,0,0
0,0,0,2,101,0,0,0,0
0,0,0,2,101,0,0,0,0
0,0,0,2,101,0,0,0,0
0,0,0,2,101,0,0,0,0
0,0,0,2,101,0,0,0,0
0,0,0,2,101,0,0,0,0
0,0,0,2,101,0,0,0,0
0,0,0,2,101,0,0,0,0
0,0,0,2,101,0,0,0,0
0,0,0,2,101,0,0,0,0
0,0,0,2,101,0,0,0,0
0,0,0,2,101,0,0,0,0
0,0,0,2,101,0,0,0,0
0,0,0,2,101,0,0,0,0
0,0,0,2,101,0,0,0,0
0,0,0,2,101,0,0,0,0
0,0,0,2,101,0,0,0,0
0,0,0,2,101,0,0,0,0
0,0,0,2,101,0,0,0,0
0,0,0,2,101,0,0,0,0
0,0,0,2,101,0,0,0,0
0,0,0,2,101,0,0,0,0
0,0,0,2,101,0,0,0,0
0,0,0,2,101,0,0,0,0
0,0,0,2,101,0,0,0,0
0,0,0,2,101,0,0,0,0
0,0,0,2,101,0,0,0,0
0,0,0,2,101,0,0,0,0
0,0,0,2,101,0,0,0,0
0,0,0,2,101,0,0,0,0
0,0,0,2,101,0,0,0,0
0,0,0,2,101,0,0,0,0
0,0,0,2,101,0,0,0,0
0,0,0,2,101,0,0,0,0
0,0,0,2,101,0,0,0,0
0,0,0,2,101,0,0,0,0
0,0,0,2,101,0,0,0,0
0,0,0,2,101,0,0,0,0
0,0,0,2,101,0,0,0,0
0,0,0,2,101,0,0,0,0
0,0,0,2,101,0,0,0,0
0,0,0,2,101,0,0,0,0
0,0,0,2,101,0,0,0,0
0,0,0,2,101,0,0,0,0
0,0,0,2,101,0,0,0,0
0,0,0,2,101,0,0,0,0
0,0,0,2,101,0,0,0,0
0,0,0,2,101,0,0,0,0
0,0,0,2,101,0,0,0,0
0,0,0,2,101,0,0,0,0
0,0,0,2,101,0,0,0,0
0,0,0,2,101,0,0,0,0
0,0,0,2,101,0,0,0,0
0,0,0,2,101,0,0,0,0
0,0,0,2,101,0,0,0,0
0,0,0,2,101,0,0,0,0
0,0,0,2,101,0,0,0,0
0,0,0,2,101,0,0,0,0
0,0,0,2,101,0,0,0,0
0,0,0,2,101,0,0,0,0
0,0,0,2,101,0,0,0,0
0,0,0,2,101,0,0,0,0
0,0,0,2,101,0,0,0,0
0,0,0,2,101,0,0,0,0
0,0,0,2,101,0,0,0,0
0,0,0,2,101,0,0,0,0
0,0,0,2,101,0,0,0,0
0,0,0,2,101,0,0,0,0
0,0,0,2,101,0,0,0,0
0,0,0,2,101,0,0,0,0
0,0,0,2,101,0,0,0,0
0,0,0,2,101,0,0,0,0
0,0,0,2,101,0,0,0,0
0,0,0,2,101,0,0,0,0
0,0,0,2,101,0,0,0,0
0,0,0,2,101,0,0,0,0
0,0,0,2,101,0,0,0,0
0,0,0,2,101,0,0,0,0
0,0,0,2,101,0,0,0,0
0,0,0,2,101,0,0,0,0
0,0,0,2,101,0,0,0,0
0,0,0,2,101,0,0,0,0
0,0,0,2,101,0,0,0,0
0,0,0,2,101,0,0,0,0
0,0,0,2,101,0,0,0,0
0,0,0,2,101,0,0,0,0
0,0,0,2,101,0,0,0,0
0,0,0,2,101,0,0,0,0
0,0,0,2,101,0,0,0,0
0,0,0,2,101,0,0,0,0
0,0,0,2,101,0,0,0,0
0,0,0,2,101,0,0,0,0
0,0,0,2,101,0,0,0,0
0,0,0,2,101,0,0,0,0
0,0,0,2,101,0,0,0,0
0,0,0,2,101,0,0,0,0
0,0,0,2,101,0,0,0,0
0,0,0,2,101,0,0,0,0
0,0,0,2,101,0,0,0,0
0,0,0,2,101,0,0,0,0
0,0,0,2,101,0,0,0,0
0,0,0,2,101,0,0,0,0
0,0,0,2,101,0,0,0,0
0,0,0,2,101,0,0,0,0
0,0,0,2,101,0,0,0,0
0,0,0,2,101,0,0,0,0
0,0,0,2,101,0,0,0,0
0,0,0,2,101,0,0,0,0
0,0,0,2,101,0,0,0,0
0,0,0,2,101,0,0,0,0
0,0,0,2,101,0,0,0,0
0,0,0,2,101,0,0,0,0
0,0,0,2,101,0,0,0,0
0,0,0,2,101,0,0,0,0
0,0,0,2,101,0,0,0,0
0,0,0,2,101,0,0,0,0
0,0,0,2,101,0,0,0,0
0,0,0,2,101,0,0,0,0
0,0,0,2,101,0,0,0,0
0,0,0,2,101,0,0,0,0
0,0,0,2,101,0,0,0,0
0,0,0,2,101,0,0,0,0
0,0,0,2,101,0,0,0,0
0,0,0,2,101,0,0,0,0
0,0,0,2,101,0,0,0,0
0,0,0,2,101,0,0,0,0
0,0,0,2,101,0,0,0,0
0,0,0,2,101,0,0,0,0
0,0,0,2,101,0,0,0,0
0,0,0,2,101,0,0,0,0
0,0,0,2,101,0,0,0,0
0,0,0,2,101,0,0,0,0
0,0,0,2,101,0,0,0,0
0,0,0,2,101,0,0,0,0
0,0,0,2,101,0,0,0,0
0,0,0,2,101,0,0,0,0
0,0,0,2,101,0,0,0,0
0,0,0,2,101,0,0,0,0
0,0,0,2,101,0,0,0,0
0,0,0,2,101,0,0,0,0
0,0,0,2,101,0,0,0,0
0,0,0,2,101,0,0,0,0
0,0,0,2,101,0,0,0,0
0,0,0,2,101,0,0,0,0
0,0,0,2,101,0,0,0,0
0,0,0,2,101,0,0,0,0
0,0,0,2,101,0,0,0,0
0,0,0,2,101,0,0,0,0
0,0,0,2,101,0,0,0,0
0,0,0,2,101,0,0,0,0
0,0,0,2,101,0,0,0,0
0,0,0,2,101,0,0,0,0
0,0,0,2,101,0,0,0,0
0,0,0,2,101,0,0,0,0
0,0,0,2,101,0,0,0,0
0,0,0,2,101,0,0,0,0
0,0,0,2,101,0,0,0,0
0,0,0,2,101,0,0,0,0
0,0,0,2,101,0,0,0,0
0,0,0,2,101,0,0,0,0
0,0,0,2,101,0,0,0,0
0,0,0,2,101,0,0,0,0
0,0,0,2,101,0,0,0,0
0,0,0,2,101,0,0,0,0
0,0,0,2,101,0,0,0,0
0,0,0,2,101,0,0,0,0
0,0,0,2,101,0,0,0,0
0,0,0,2,101,0,0,0,0
0,0,0,2,101,0,0,0,0
0,0,0,2,101,0,0,0,0
0,0,0,2,101,0,0,0,0
0,0,0,2,101,0,0,0,0
0,0,0,2,101,0,0,0,0
0,0,0,2,101,0,0,0,0
0,0,0,2,101,0,0,0,0
0,0,0,2,101,0,0,0,0
0,0,0,2,101,0,0,0,0
0,0,0,2,101,0,0,0,0
0,0,0,2,101,0,0,0,0
0,0,0,2,101,0,0,0,0
0,0,0,2,101,0,0,0,0
0,0,0,2,101,0,0,0,0
0,0,0,2,101,0,0,0,0
0,0,0,2,101,0,0,0,0
0,0,0,2,101,0,0,0,0
0,0,0,2,101,0,0,0,0
0,0,0,2,101,0,0,0,0
0,0,0,2,101,0,0,0,0
0,0,0,2,101,0,0,0,0
0,0,0,2,101,0,0,0,0
0,0,0,2,101,0,0,0,0
0,0,0,2,101,0,0,0,0
0,0,0,2,101,0,0,0,0
0,0,0,2,101,0,0,0,0
0,0,0,2,101,0,0,0,0
0,0,0,2,101,0,0,0,0
0,0,0,2,101,0,0,0,0
0,0,0,2,101,0,0,0,0
0,0,0,2,101,0,0,0,0
0,0,0,2,101,0,0,0,0
0,0,0,2,101,0,0,0,0
0,0,0,2,101,0,0,0,0
0,0,0,2,101,0,0,0,0
0,0,0,2,101,0,0,0,0
0,0,0,2,101,0,0,0,0
0,0,0,2,101,0,0,0,0
0,0,0,2,101,0,0,0,0
0,0,0,2,101,0,0,0,0
0,0,0,2,101,0,0,0,0
0,0,0,2,101,0,0,0,0
0,0,0,2,101,0,0,0,0
0,0,0,2,101,0,0,0,0
0,0,0,2,101,0,0,0,0
0,0,0,2,101,0,0,0,0
0,0,0,2,101,0,0,0,0
0,0,0,2,101,0,0,0,0
0,0,0,2,101,0,0,0,0
0,0,0,2,101,0,0,0,0
0,0,0,2,101,0,0,0,0
0,0,0,2,101,0,0,0,0
0,0,0,2,101,0,0,0,0
0,0,0,2,101,0,0,0,0
0,0,0,2,101,0,0,0,0
0,0,0,2,101,0,0,0,0
0,0,0,2,101,0,0,0,0
0,0,0,2,101,0,0,0,0
0,0,0,2,101,0,0,0,0
0,0,0,2,101,0,0,0,0
0,0,0,2,101,0,0,0,0
0,0,0,2,101,0,0,0,0
0,0,0,2,101,0,0,0,0
0,0,0,2,101,0,0,0,0
0,0,0,2,101,0,0,0,0
0,0,0,2,101,0,0,0,0
0,0,0,2,101,0,0,0,0
0,0,0,2,101,0,0,0,0
0,0,0,2,101,0,0,0,0
0,0,0,2,101,0,0,0,0
0,0,0,2,101,0,0,0,0
0,0,0,2,101,0,0,0,0
0,0,0,2,101,0,0,0,0
0,0,0,2,101,0,0,0,0
0,0,0,2,101,0,0,0,0
0,0,0,2,101,0,0,0,0
0,0,0,2,101,0,0,0,0
0,0,0,2,101,0,0,0,0
0,0,0,2,101,0,0,0,0
0,0,0,2,101,0,0,0,0
0,0,0,2,101,0,0,0,0
0,0,0,2,101,0,0,0,0
0,0,0,2,101,0,0,0,0
0,0,0,2,101,0,0,0,0
0,0,0,2,101,0,0,0,0
0,0,0,2,101,0,0,0,0
0,0,0,2,101,0,0,0,0
0,0,0,2,101,0,0,0,0
0,0,0,2,101,0,0,0,0
0,0,0,2,101,0,0,0,0
0,0,0,2,101,0,0,0,0
0,0,0,2,101,0,0,0,0
0,0,0,2,101,0,0,0,0
0,0,0,2,101,0,0,0,0
0,0,0,2,101,0,0,0,0
0,0,0,2,101,0,0,0,0
0,0,0,2,101,0,0,0,0
0,0,0,2,101,0,0,0,0
0,0,0,2,101,0,0,0,0
0,0,0,2,101,0,0,0,0
0,0,0,2,101,0,0,0,0
0,0,0,2,101,0,0,0,0
0,0,0,2,101,0,0,0,0
0,0,0,2,101,0,0,0,0
0,0,0,2,101,0,0,0,0
0,0,0,2,101,0,0,0,0
0,0,0,2,101,0,0,0,0
0,0,0,2,101,0,0,0,0
0,0,0,2,101,0,0,0,0
0,0,0,2,101,0,0,0,0
0,0,0,2,101,0,0,0,0
0,0,0,2,101,0,0,0,0
0,0,0,2,101,0,0,0,0
0,0,0,2,101,0,0,0,0
0,0,0,2,101,0,0,0,0
0,0,0,2,101,0,0,0,0
0,0,0,2,101,0,0,0,0
0,0,0,2,101,0,0,0,0
0,0,0,2,101,0,0,0,0
0,0,0,2,101,0,0,0,0
0,0,0,2,101,0,0,0,0
0,0,0,2,101,0,0,0,0
0,0,0,2,101,0,0,0,0
0,0,0,2,101,0,0,0,0
0,0,0,2,101,0,0,0,0
0,0,0,2,101,0,0,0,0
0,0,0,2,101,0,0,0,0
0,0,0,2,101,0,0,0,0
0,0,0,2,101,0,0,0,0
0,0,0,2,101,0,0,0,0
0,0,0,2,101,0,0,0,0
0,0,0,2,101,0,0,0,0
0,0,0,2,101,0,0,0,0
0,0,0,2,101,0,0,0,0
0,0,0,2,101,0,0,0,0
0,0,0,2,101,0,0,0,0
0,0,0,2,101,0,0,0,0
0,0,0,2,101,0,0,0,0
0,0,0,2,101,0,0,0,0
0,0,0,2,101,0,0,0,0
0,0,0,2,101,0,0,0,0
0,0,0,2,101,0,0,0,0
0,0,0,2,101,0,0,0,0
0,0,0,2,101,0,0,0,0
0,0,0,2,101,0,0,0,0
0,0,0,2,101,0,0,0,0
0,0,0,2,101,0,0,0,0
0,0,0,2,101,0,0,0,0
0,0,0,2,101,0,0,0,0
0,0,0,2,101,0,0,0,0
0,0,0,2,101,0,0,0,0
0,0,0,2,101,0,0,0,0
0,0,0,2,101,0,0,0,0
0,0,0,2,101,0,0,0,0
0,0,0,2,101,0,0,0,0
0,0,0,2,101,0,0,0,0
0,0,0,2,101,0,0,0,0
0,0,0,2,101,0,0,0,0
0,0,0,2,101,0,0,0,0
0,0,0,2,101,0,0,0,0
0,0,0,2,101,0,0,0,0
0,0,0,2,101,0,0,0,0
0,0,0,2,101,0,0,0,0
0,0,0,2,101,0,0,0,0
0,0,0,2,101,0,0,0,0
0,0,0,2,101,0,0,0,0
0,0,0,2,101,0,0,0,0
0,0,0,2,101,0,0,0,0
0,0,0,2,101,0,0,0,0
0,0,0,2,101,0,0,0,0
0,0,0,2,101,0,0,0,0
0,0,0,2,101,0,0,0,0
0,0,0,2,101,0,0,0,0
0,0,0,2,101,0,0,0,0
0,0,0,2,101,0,0,0,0
0,0,0,2,101,0,0,0,0
0,0,0,2,101,0,0,0,0
0,0,0,2,101,0,0,0,0
0,0,0,2,101,0,0,0,0
0,0,0,2,101,0,0,0,0
0,0,0,2,101,0,0,0,0
0,0,0,2,101,0,0,0,0
0,0,0,2,101,0,0,0,0
0,0,0,2,101,0,0,0,0
0,0,0,2,101,0,0,0,0
0,0,0,2,101,0,0,0,0
0,0,0,2,101,0,0,0,0
0,0,0,2,101,0,0,0,0
0,0,0,2,101,0,0,0,0
0,0,0,2,101,0,0,0,0
0,0,0,2,101,0,0,0,0
0,0,0,2,101,0,0,0,0
0,0,0,2,101,0,0,0,0
0,0,0,2,101,0,0,0,0
0,0,0,2,101,0,0,0,0
0,0,0,2,101,0,0,0,0
0,0,0,2,101,0,0,0,0
0,0,0,2,101,0,0,0,0
0,0,0,2,101,0,0,0,0
0,0,0,2,101,0,0,0,0
0,0,0,2,101,0,0,0,0
0,0,0,2,101,0,0,0,0
0,0,0,2,101,0,0,0,0
0,0,0,2,101,0,0,0,0
0,0,0,2,101,0,0,0,0
0,0,0,2,101,0,0,0,0
0,0,0,2,101,0,0,0,0
0,0,0,2,101,0,0,0,0
0,0,0,2,101,0,0,0,0
0,0,0,2,101,0,0,0,0
0,0,0,2,101,0,0,0,0
0,0,0,2,101,0,0,0,0
0,0,0,2,101,0,0,0,0
0,0,0,2,101,0,0,0,0
0,0,0,2,101,0,0,0,0
0,0,0,2,101,0,0,0,0
0,0,0,2,101,0,0,0,0
0,0,0,2,101,0,0,0,0
0,0,0,2,101,0,0,0,0
0,0,0,2,101,0,0,0,0
0,0,0,2,101,0,0,0,0
0,0,0,2,101,0,0,0,0
0,0,0,2,101,0,0,0,0
0,0,0,2,101,0,0,0,0
0,0,0,2,101,0,0,0,0
0,0,0,2,101,0,0,0,0
0,0,0,2,101,0,0,0,0
0,0,0,2,101,0,0,0,0
0,0,0,2,101,0,0,0,0
0,0,0,2,101,0,0,0,0
0,0,0,2,101,0,0,0,0
0,0,0,2,101,0,0,0,0
0,0,0,2,101,0,0,0,0
0,0,0,2,101,0,0,0,0
0,0,0,2,101,0,0,0,0
0,0,0,2,101,0,0,0,0
0,0,0,2,101,0,0,0,0
0,0,0,2,101,0,0,0,0
0,0,0,2,101,0,0,0,0
0,0,0,2,101,0,0,0,0
0,0,0,2,101,0,0,0,0
0,0,0,2,101,0,0,0,0
0,0,0,2,101,0,0,0,0
0,0,0,2,101,0,0,0,0
0,0,0,2,101,0,0,0,0
0,0,0,2,101,0,0,0,0
0,0,0,2,101,0,0,0,0
0,0,0,2,101,0,0,0,0
0,0,0,2,101,0,0,0,0
0,0,0,2,101,0,0,0,0
0,0,0,2,101,0,0,0,0
0,0,0,2,101,0,0,0,0
0,0,0,2,101,0,0,0,0
0,0,0,2,101,0,0,0,0
0,0,0,2,101,0,0,0,0
0,0,0,2,101,0,0,0,0
0,0,0,2,101,0,0,0,0
0,0,0,2,101,0,0,0,0
0,0,0,2,101,0,0,0,0
0,0,0,2,101,0,0,0,0
0,0,0,2,101,0,0,0,0
0,0,0,2,101,0,0,0,0
0,0,0,2,101,0,0,0,0
0,0,0,2,101,0,0,0,0
0,0,0,2,101,0,0,0,0
0,0,0,2,101,0,0,0,0
0,0,0,2,101,0,0,0,0
0,0,0,2,101,0,0,0,0
0,0,0,2,101,0,0,0,0
0,0,0,2,101,0,0,0,0
0,0,0,2,101,0,0,0,0
0,0,0,2,101,0,0,0,0
0,0,0,2,101,0,0,0,0
0,0,0,2,101,0,0,0,0
0,0,0,2,101,0,0,0,0
0,0,0,2,101,0,0,0,0
0,0,0,2,101,0,0,0,0
0,0,0,2,101,0,0,0,0
0,0,0,2,101,0,0,0,0
0,0,0,2,101,0,0,0,0
0,0,0,2,101,0,0,0,0
0,0,0,2,101,0,0,0,0
0,0,0,2,101,0,0,0,0
0,0,0,2,101,0,0,0,0
0,0,0,2,101,0,0,0,0
0,0,0,2,101,0,0,0,0
0,0,0,2,101,0,0,0,0
0,0,0,2,101,0,0,0,0
0,0,0,2,101,0,0,0,0
0,0,0,2,101,0,0,0,0
0,0,0,2,101,0,0,0,0
0,0,0,2,101,0,0,0,0
0,0,0,2,101,0,0,0,0
0,0,0,2,101,0,0,0,0
0,0,0,2,101,0,0,0,0
0,0,0,2,101,0,0,0,0
0,0,0,2,101,0,0,0,0
0,0,0,2,101,0,0,0,0
0,0,0,2,101,0,0,0,0
0,0,0,2,101,0,0,0,0
0,0,0,2,101,0,0,0,0
0,0,0,2,101,0,0,0,0
0,0,0,2,101,0,0,0,0
0,0,0,2,101,0,0,0,0
0,0,0,2,101,0,0,0,0
0,0,0,2,101,0,0,0,0
0,0,0,2,101,0,0,0,0
0,0,0,2,101,0,0,0,0
0,0,0,2,101,0,0,0,0
0,0,0,2,101,0,0,0,0
0,0,0,2,101,0,0,0,0
0,0,0,2,101,0,0,0,0
0,0,0,2,101,0,0,0,0
0,0,0,2,101,0,0,0,0
0,0,0,2,101,0,0,0,0
0,0,0,2,101,0,0,0,0
0,0,0,2,101,0,0,0,0
0,0,0,2,101,0,0,0,0
0,0,0,2,101,0,0,0,0
0,0,0,2,101,0,0,0,0
0,0,0,2,101,0,0,0,0
0,0,0,2,101,0,0,0,0
0,0,0,2,101,0,0,0,0
0,0,0,2,101,0,0,0,0
0,0,0,2,101,0,0,0,0
0,0,0,2,101,0,0,0,0
0,0,0,2,101,0,0,0,0
0,0,0,2,101,0,0,0,0
0,0,0,2,101,0,0,0,0
0,0,0,2,101,0,0,0,0
0,0,0,2,101,0,0,0,0
0,0,0,2,101,0,0,0,0
0,0,0,2,101,0,0,0,0
0,0,0,2,101,0,0,0,0
0,0,0,2,101,0,0,0,0
0,0,0,2,101,0,0,0,0
0,0,0,2,101,0,0,0,0
0,0,0,2,101,0,0,0,0
0,0,0,2,101,0,0,0,0
0,0,0,2,101,0,0,0,0
0,0,0,2,101,0,0,0,0
0,0,0,2,101,0,0,0,0
0,0,0,2,101,0,0,0,0
0,0,0,2,101,0,0,0,0
0,0,0,2,101,0,0,0,0
0,0,0,2,101,0,0,0,0
0,0,0,2,101,0,0,0,0
0,0,0,2,101,0,0,0,0
0,0,0,2,101,0,0,0,0
0,0,0,2,101,0,0,0,0
0,0,0,2,101,0,0,0,0
0,0,0,2,101,0,0,0,0
0,0,0,2,101,0,0,0,0
0,0,0,2,101,0,0,0,0
0,0,0,2,101,0,0,0,0
0,0,0,2,101,0,0,0,0
0,0,0,2,101,0,0,0,0
0,0,0,2,101,0,0,0,0
0,0,0,2,101,0,0,0,0
0,0,0,2,101,0,0,0,0
0,0,0,2,101,0,0,0,0
0,0,0,2,101,0,0,0,0
0,0,0,2,101,0,0,0,0
0,0,0,2,101,0,0,0,0
0,0,0,2,101,0,0,0,0
0,0,0,2,101,0,0,0,0
0,0,0,2,101,0,0,0,0
0,0,0,2,101,0,0,0,0
0,0,0,2,101,0,0,0,0
0,0,0,2,101,0,0,0,0
0,0,0,2,101,0,0,0,0
0,0,0,2,101,0,0,0,0
0,0,0,2,101,0,0,0,0
0,0,0,2,101,0,0,0,0
0,0,0,2,101,0,0,0,0
0,0,0,2,101,0,0,0,0
0,0,0,2,101,0,0,0,0
0,0,0,2,101,0,0,0,0
0,0,0,2,101,0,0,0,0
0,0,0,2,101,0,0,0,0
0,0,0,2,101,0,0,0,0
0,0,0,2,101,0,0,0,0
0,0,0,2,101,0,0,0,0
0,0,0,2,101,0,0,0,0
0,0,0,2,101,0,0,0,0
0,0,0,2,101,0,0,0,0
0,0,0,2,101,0,0,0,0
0,0,0,2,101,0,0,0,0
0,0,0,2,101,0,0,0,0
0,0,0,2,101,0,0,0,0
0,0,0,2,101,0,0,0,0
0,0,0,2,101,0,0,0,0
0,0,0,2,101,0,0,0,0
0,0,0,2,101,0,0,0,0
0,0,0,2,101,0,0,0,0
0,0,0,2,101,0,0,0,0
0,0,0,2,101,0,0,0,0
0,0,0,2,101,0,0,0,0
0,0,0,2,101,0,0,0,0
0,0,0,2,101,0,0,0,0
0,0,0,2,101,0,0,0,0
0,0,0,2,101,0,0,0,0
0,0,0,2,101,0,0,0,0
0,0,0,2,101,0,0,0,0
0,0,0,2,101,0,0,0,0
0,0,0,2,101,0,0,0,0
0,0,0,2,101,0,0,0,0
0,0,0,2,101,0,0,0,0
0,0,0,2,101,0,0,0,0
0,0,0,2,101,0,0,0,0
0,0,0,2,101,0,0,0,0
0,0,0,2,101,0,0,0,0
0,0,0,2,101,0,0,0,0
0,0,0,2,101,0,0,0,0
0,0,0,2,101,0,0,0,0
0,0,0,2,101,0,0,0,0
0,0,0,2,101,0,0,0,0
0,0,0,2,101,0,0,0,0
0,0,0,2,101,0,0,0,0
0,0,0,2,101,0,0,0,0
0,0,0,2,101,0,0,0,0
0,0,0,2,101,0,0,0,0
0,0,0,2,101,0,0,0,0
0,0,0,2,101,0,0,0,0
0,0,0,2,101,0,0,0,0
0,0,0,2,101,0,0,0,0
0,0,0,2,101,0,0,0,0
0,0,0,2,101,0,0,0,0
0,0,0,2,101,0,0,0,0
0,0,0,2,101,0,0,0,0
0,0,0,2,101,0,0,0,0
0,0,0,2,101,0,0,0,0
0,0,0,2,101,0,0,0,0
0,0,0,2,101,0,0,0,0
0,0,0,2,101,0,0,0,0
0,0,0,2,101,0,0,0,0
0,0,0,2,101,0,0,0,0
0,0,0,2,101,0,0,0,0
0,0,0,2,101,0,0,0,0
0,0,0,2,101,0,0,0,0
0,0,0,2,101,0,0,0,0
0,0,0,2,101,0,0,0,0
0,0,0,2,101,0,0,0,0
0,0,0,2,101,0,0,0,0
0,0,0,2,101,0,0,0,0
0,0,0,2,101,0,0,0,0
0,0,0,2,101,0,0,0,0
0,0,0,2,101,0,0,0,0
0,0,0,2,101,0,0,0,0
0,0,0,2,101,0,0,0,0
0,0,0,2,101,0,0,0,0
0,0,0,2,101,0,0,0,0
0,0,0,2,101,0,0,0,0
0,0,0,2,101,0,0,0,0
0,0,0,2,101,0,0,0,0
0,0,0,2,101,0,0,0,0
0,0,0,2,101,0,0,0,0
0,0,0,2,101,0,0,0,0
0,0,0,2,101,0,0,0,0
0,0,0,2,101,0,0,0,0
0,0,0,2,101,0,0,0,0
0,0,0,2,101,0,0,0,0
0,0,0,2,101,0,0,0,0
0,0,0,2,101,0,0,0,0
0,0,0,2,101,0,0,0,0
0,0,0,2,101,0,0,0,0
0,0,0,2,101,0,0,0,0
0,0,0,2,101,0,0,0,0
0,0,0,2,101,0,0,0,0
0,0,0,2,101,0,0,0,0
0,0,0,2,101,0,0,0,0
0,0,0,2,101,0,0,0,0
0,0,0,2,101,0,0,0,0
0,0,0,2,101,0,0,0,0
0,0,0,2,101,0,0,0,0
0,0,0,2,101,0,0,0,0
0,0,0,2,101,0,0,0,0
0,0,0,2,101,0,0,0,0
0,0,0,2,101,0,0,0,0
0,0,0,2,101,0,0,0,0
0,0,0,2,101,0,0,0,0
0,0,0,2,101,0,0,0,0
0,0,0,2,101,0,0,0,0
0,0,0,2,101,0,0,0,0
0,0,0,2,101,0,0,0,0
0,0,0,2,101,0,0,0,0
0,0,0,2,101,0,0,0,0
0,0,0,2,101,0,0,0,0
0,0,0,2,101,0,0,0,0
0,0,0,2,101,0,0,0,0
0,0,0,2,101,0,0,0,0
0,0,0,2,101,0,0,0,0
0,0,0,2,101,0,0,0,0
0,0,0,2,101,0,0,0,0
0,0,0,2,101,0,0,0,0
0,0,0,2,101,0,0,0,0
0,0,0,2,101,0,0,0,0
0,0,0,2,101,0,0,0,0
0,0,0,2,101,0,0,0,0
0,0,0,2,101,0,0,0,0
0,0,0,2,101,0,0,0,0
0,0,0,2,101,0,0,0,0
0,0,0,2,101,0,0,0,0
0,0,0,2,101,0,0,0,0
0,0,0,2,101,0,0,0,0
0,0,0,2,101,0,0,0,0
0,0,0,2,101,0,0,0,0
0,0,0,2,101,0,0,0,0
0,0,0,2,101,0,0,0,0
0,0,0,2,101,0,0,0,0
0,0,0,2,101,0,0,0,0
0,0,0,2,101,0,0,0,0
0,0,0,2,101,0,0,0,0
0,0,0,2,101,0,0,0,0
0,0,0,2,101,0,0,0,0
0,0,0,2,101,0,0,0,0
0,0,0,2,101,0,0,0,0
0,0,0,2,101,0,0,0,0
0,0,0,2,101,0,0,0,0
0,0,0,2,101,0,0,0,0
0,0,0,2,101,0,0,0,0
0,0,0,2,101,0,0,0,0
0,0,0,2,101,0,0,0,0
0,0,0,2,101,0,0,0,0
0,0,0,2,101,0,0,0,0
0,0,0,2,101,0,0,0,0
0,0,0,2,101,0,0,0,0
0,0,0,2,101,0,0,0,0
0,0,0,2,101,0,0,0,0
0,0,0,2,101,0,0,0,0
0,0,0,2,101,0,0,0,0
0,0,0,2,101,0,0,0,0
0,0,0,2,101,0,0,0,0
0,0,0,2,101,0,0,0,0
0,0,0,2,101,0,0,0,0
0,0,0,2,101,0,0,0,0
0,0,0,2,101,0,0,0,0
0,0,0,2,101,0,0,0,0
0,0,0,2,101,0,0,0,0
0,0,0,2,101,0,0,0,0
0,0,0,2,101,0,0,0,0
0,0,0,2,101,0,0,0,0
0,0,0,2,101,0,0,0,0
0,0,0,2,101,0,0,0,0
0,0,0,2,101,0,0,0,0
0,0,0,2,101,0,0,0,0
0,0,0,2,101,0,0,0,0
0,0,0,2,101,0,0,0,0
0,0,0,2,101,0,0,0,0
0,0,0,2,101,0,0,0,0
0,0,0,2,101,0,0,0,0
0,0,0,2,101,0,0,0,0
0,0,0,2,101,0,0,0,0
0,0,0,2,101,0,0,0,0
0,0,0,2,101,0,0,0,0
0,0,0,2,101,0,0,0,0
0,0,0,2,101,0,0,0,0
0,0,0,2,101,0,0,0,0
0,0,0,2,101,0,0,0,0
0,0,0,2,101,0,0,0,0
0,0,0,2,101,0,0,0,0
0,0,0,2,101,0,0,0,0
0,0,0,2,101,0,0,0,0
0,0,0,2,101,0,0,0,0
0,0,0,2,101,0,0,0,0
0,0,0,2,101,0,0,0,0
0,0,0,2,101,0,0,0,0
0,0,0,2,101,0,0,0,0
0,0,0,2,101,0,0,0,0
0,0,0,2,101,0,0,0,0
0,0,0,2,101,0,0,0,0
0,0,0,2,101,0,0,0,0
0,0,0,2,101,0,0,0,0
0,0,0,2,101,0,0,0,0
0,0,0,2,101,0,0,0,0
0,0,0,2,101,0,0,0,0
0,0,0,2,101,0,0,0,0
0,0,0,2,101,0,0,0,0
0,0,0,2,101,0,0,0,0
0,0,0,2,101,0,0,0,0
0,0,0,2,101,0,0,0,0
0,0,0,2,101,0,0,0,0
0,0,0,2,101,0,0,0,0
0,0,0,2,101,0,0,0,0
0,0,0,2,101,0,0,0,0
0,0,0,2,101,0,0,0,0
0,0,0,2,101,0,0,0,0
0,0,0,2,101,0,0,0,0
0,0,0,2,101,0,0,0,0
0,0,0,2,101,0,0,0,0
0,0,0,2,101,0,0,0,0
0,0,0,2,101,0,0,0,0
0,0,0,2,101,0,0,0,0
0,0,0,2,101,0,0,0,0
0,0,0,2,101,0,0,0,0
0,0,0,2,101,0,0,0,0
0,0,0,2,101,0,0,0,0
0,0,0,2,101,0,0,0,0
0,0,0,2,101,0,0,0,0
0,0,0,2,101,0,0,0,0
0,0,0,2,101,0,0,0,0
0,0,0,2,101,0,0,0,0
0,0,0,2,101,0,0,0,0
0,0,0,2,101,0,0,0,0
0,0,0,2,101,0,0,0,0
0,0,0,2,101,0,0,0,0
0,0,0,2,101,0,0,0,0
0,0,0,2,101,0,0,0,0
0,0,0,2,101,0,0,0,0
0,0,0,2,101,0,0,0,0
0,0,0,2,101,0,0,0,0
0,0,0,2,101,0,0,0,0
0,0,0,2,101,0,0,0,0
0,0,0,2,101,0,0,0,0
0,0,0,2,101,0,0,0,0
0,0,0,2,101,0,0,0,0
0,0,0,2,101,0,0,0,0
0,0,0,2,101,0,0,0,0
0,0,0,2,101,0,0,0,0
0,0,0,2,101,0,0,0,0
0,0,0,2,101,0,0,0,0
0,0,0,2,101,0,0,0,0
0,0,0,2,101,0,0,0,0
0,0,0,2,101,0,0,0,0
0,0,0,2,101,0,0,0,0
0,0,0,2,101,0,0,0,0
0,0,0,2,101,0,0,0,0
0,0,0,2,101,0,0,0,0
0,0,0,2,101,0,0,0,0
0,0,0,2,101,0,0,0,0
0,0,0,2,101,0,0,0,0
0,0,0,2,101,0,0,0,0
0,0,0,2,101,0,0,0,0
0,0,0,2,101,0,0,0,0
0,0,0,2,101,0,0,0,0
0,0,0,2,101,0,0,0,0
0,0,0,2,101,0,0,0,0
0,0,0,2,101,0,0,0,0
0,0,0,2,101,0,0,0,0
0,0,0,2,101,0,0,0,0
0,0,0,2,101,0,0,0,0
0,0,0,2,101,0,0,0,0
0,0,0,2,101,0,0,0,0
0,0,0,2,101,0,0,0,0
0,0,0,2,101,0,0,0,0
0,0,0,2,101,0,0,0,0
0,0,0,2,101,0,0,0,0
0,0,0,2,101,0,0,0,0
0,0,0,2,101,0,0,0,0
0,0,0,2,101,0,0,0,0
0,0,0,2,101,0,0,0,0
0,0,0,2,101,0,0,0,0
0,0,0,2,101,0,0,0,0
0,0,0,2,101,0,0,0,0
0,0,0,2,101,0,0,0,0
0,0,0,2,101,0,0,0,0
0,0,0,2,101,0,0,0,0
0,0,0,2,101,0,0,0,0
0,0,0,2,101,0,0,0,0
0,0,0,2,101,0,0,0,0
0,0,0,2,101,0,0,0,0
0,0,0,2,101,0,0,0,0
0,0,0,2,101,0,0,0,0
0,0,0,2,101,0,0,0,0
0,0,0,2,101,0,0,0,0
0,0,0,2,101,0,0,0,0
0,0,0,2,101,0,0,0,0
0,0,0,2,101,0,0,0,0
0,0,0,2,101,0,0,0,0
0,0,0,2,101,0,0,0,0
0,0,0,2,101,0,0,0,0
0,0,0,2,101,0,0,0,0
0,0,0,2,101,0,0,0,0
0,0,0,2,101,0,0,0,0
0,0,0,2,101,0,0,0,0
0,0,0,2,101,0,0,0,0
0,0,0,2,101,0,0,0,0
0,0,0,2,101,0,0,0,0
0,0,0,2,101,0,0,0,0
0,0,0,2,101,0,0,0,0
0,0,0,2,101,0,0,0,0
0,0,0,2,101,0,0,0,0
0,0,0,2,101,0,0,0,0
0,0,0,2,101,0,0,0,0
0,0,0,2,101,0,0,0,0
0,0,0,2,101,0,0,0,0
0,0,0,2,101,0,0,0,0
0,0,0,2,101,0,0,0,0
0,0,0,2,101,0,0,0,0
0,0,0,2,101,0,0,0,0
0,0,0,2,101,0,0,0,0
0,0,0,2,101,0,0,0,0
0,0,0,2,101,0,0,0,0
0,0,0,2,101,0,0,0,0
0,0,0,2,101,0,0,0,0
0,0,0,2,101,0,0,0,0
0,0,0,2,101,0,0,0,0
0,0,0,2,101,0,0,0,0
0,0,0,2,101,0,0,0,0
0,0,0,2,101,0,0,0,0
0,0,0,2,101,0,0,0,0
0,0,0,2,101,0,0,0,0
0,0,0,2,101,0,0,0,0
0,0,0,2,101,0,0,0,0
0,0,0,2,101,0,0,0,0
0,0,0,2,101,0,0,0,0
0,0,0,2,101,0,0,0,0
0,0,0,2,101,0,0,0,0
0,0,0,2,101,0,0,0,0
0,0,0,2,101,0,0,0,0
0,0,0,2,101,0,0,0,0
0,0,0,2,101,0,0,0,0
0,0,0,2,101,0,0,0,0
0,0,0,2,101,0,0,0,0
0,0,0,2,101,0,0,0,0
0,0,0,2,101,0,0,0,0
0,0,0,2,101,0,0,0,0
0,0,0,2,101,0,0,0,0
0,0,0,2,101,0,0,0,0
0,0,0,2,101,0,0,0,0
0,0,0,2,101,0,0,0,0
0,0,0,2,101,0,0,0,0
0,0,0,2,101,0,0,0,0
0,0,0,2,101,0,0,0,0
0,0,0,2,101,0,0,0,0
0,0,0,2,101,0,0,0,0
0,0,0,2,101,0,0,0,0
0,0,0,2,101,0,0,0,0
0,0,0,2,101,0,0,0,0
0,0,0,2,101,0,0,0,0
0,0,0,2,101,0,0,0,0
0,0,0,2,101,0,0,0,0
0,0,0,2,101,0,0,0,0
0,0,0,2,101,0,0,0,0
0,0,0,2,101,0,0,0,0
0,0,0,2,101,0,0,0,0
0,0,0,2,101,0,0,0,0
0,0,0,2,101,0,0,0,0
0,0,0,2,101,0,0,0,0
0,0,0,2,101,0,0,0,0
0,0,0,2,101,0,0,0,0
0,0,0,2,101,0,0,0,0
0,0,0,2,101,0,0,0,0
0,0,0,2,101,0,0,0,0
0,0,0,2,101,0,0,0,0
0,0,0,2,101,0,0,0,0
0,0,0,2,101,0,0,0,0
0,0,0,2,101,0,0,0,0
0,0,0,2,101,0,0,0,0
0,0,0,2,101,0,0,0,0
0,0,0,2,101,0,0,0,0
0,0,0,2,101,0,0,0,0
0,0,0,2,101,0,0,0,0
0,0,0,2,101,0,0,0,0
0,0,0,2,101,0,0,0,0
0,0,0,2,101,0,0,0,0
0,0,0,2,101,0,0,0,0
0,0,0,2,101,0,0,0,0
0,0,0,2,101,0,0,0,0
0,0,0,2,101,0,0,0,0
0,0,0,2,101,0,0,0,0
0,0,0,2,101,0,0,0,0
0,0,0,2,101,0,0,0,0
0,0,0,2,101,0,0,0,0
0,0,0,2,101,0,0,0,0
0,0,0,2,101,0,0,0,0
0,0,0,2,101,0,0,0,0
0,0,0,2,101,0,0,0,0
0,0,0,2,101,0,0,0,0
0,0,0,2,101,0,0,0,0
0,0,0,2,101,0,0,0,0
0,0,0,2,101,0,0,0,0
0,0,0,2,101,0,0,0,0
0,0,0,2,101,0,0,0,0
0,0,0,2,101,0,0,0,0
0,0,0,2,101,0,0,0,0
0,0,0,2,101,0,0,0,0
0,0,0,2,101,0,0,0,0
0,0,0,2,101,0,0,0,0
0,0,0,2,101,0,0,0,0
0,0,0,2,101,0,0,0,0
0,0,0,2,101,0,0,0,0
0,0,0,2,101,0,0,0,0
0,0,0,2,101,0,0,0,0
0,0,0,2,101,0,0,0,0
0,0,0,2,101,0,0,0,0
0,0,0,2,101,0,0,0,0
0,0,0,2,101,0,0,0,0
0,0,0,2,101,0,0,0,0
0,0,0,2,101,0,0,0,0
0,0,0,2,101,0,0,0,0
0,0,0,2,101,0,0,0,0
0,0,0,2,101,0,0,0,0
0,0,0,2,101,0,0,0,0
0,0,0,2,101,0,0,0,0
0,0,0,2,101,0,0,0,0
0,0,0,2,101,0,0,0,0
0,0,0,2,101,0,0,0,0
0,0,0,2,101,0,0,0,0
0,0,0,2,101,0,0,0,0
0,0,0,2,101,0,0,0,0
0,0,0,2,101,0,0,0,0
0,0,0,2,101,0,0,0,0
0,0,0,2,101,0,0,0,0
0,0,0,2,101,0,0,0,0
0,0,0,2,101,0,0,0,0
0,0,0,2,101,0,0,0,0
0,0,0,2,101,0,0,0,0
0,0,0,2,101,0,0,0,0
0,0,0,2,101,0,0,0,0
0,0,0,2,101,0,0,0,0
0,0,0,2,101,0,0,0,0
0,0,0,2,101,0,0,0,0
0,0,0,2,101,0,0,0,0
0,0,0,2,101,0,0,0,0
0,0,0,2,101,0,0,0,0
0,0,0,2,101,0,0,0,0
0,0,0,2,101,0,0,0,0
0,0,0,2,101,0,0,0,0
0,0,0,2,101,0,0,0,0
0,0,0,2,101,0,0,0,0
0,0,0,2,101,0,0,0,0
0,0,0,2,101,0,0,0,0
0,0,0,2,101,0,0,0,0
0,0,0,2,101,0,0,0,0
0,0,0,2,101,0,0,0,0
0,0,0,2,101,0,0,0,0
0,0,0,2,101,0,0,0,0
0,0,0,2,101,0,0,0,0
0,0,0,2,101,0,0,0,0
0,0,0,2,101,0,0,0,0
0,0,0,2,101,0,0,0,0
0,0,0,2,101,0,0,0,0
0,0,0,2,101,0,0,0,0
0,0,0,2,101,0,0,0,0
0,0,0,2,101,0,0,0,0
0,0,0,2,101,0,0,0,0
0,0,0,2,101,0,0,0,0
0,0,0,2,101,0,0,0,0
0,0,0,2,101,0,0,0,0
0,0,0,2,101,0,0,0,0
0,0,0,2,101,0,0,0,0
0,0,0,2,101,0,0,0,0
0,0,0,2,101,0,0,0,0
0,0,0,2,101,0,0,0,0
0,0,0,2,101,0,0,0,0
0,0,0,2,101,0,0,0,0
0,0,0,2,101,0,0,0,0
0,0,0,2,101,0,0,0,0
0,0,0,2,101,0,0,0,0
0,0,0,2,101,0,0,0,0
0,0,0,2,101,0,0,0,0
0,0,0,2,101,0,0,0,0
0,0,0,2,101,0,0,0,0
0,0,0,2,101,0,0,0,0
0,0,0,2,101,0,0,0,0
0,0,0,2,101,0,0,0,0
0,0,0,2,101,0,0,0,0
0,0,0,2,101,0,0,0,0
0,0,0,2,101,0,0,0,0
0,0,0,2,101,0,0,0,0
0,0,0,2,101,0,0,0,0
0,0,0,2,101,0,0,0,0
0,0,0,2,101,0,0,0,0
0,0,0,2,101,0,0,0,0
0,0,0,2,101,0,0,0,0
0,0,0,2,101,0,0,0,0
0,0,0,2,101,0,0,0,0
0,0,0,2,101,0,0,0,0
0,0,0,2,101,0,0,0,0
0,0,0,2,101,0,0,0,0
0,0,0,2,101,0,0,0,0
0,0,0,2,101,0,0,0,0
0,0,0,2,101,0,0,0,0
0,0,0,2,101,0,0,0,0
0,0,0,2,101,0,0,0,0
0,0,0,2,101,0,0,0,0
0,0,0,2,101,0,0,0,0
0,0,0,2,101,0,0,0,0
0,0,0,2,101,0,0,0,0
0,0,0,2,101,0,0,0,0
0,0,0,2,101,0,0,0,0
0,0,0,2,101,0,0,0,0
0,0,0,2,101,0,0,0,0
0,0,0,2,101,0,0,0,0
0,0,0,2,101,0,0,0,0
0,0,0,2,101,0,0,0,0
0,0,0,2,101,0,0,0,0
0,0,0,2,101,0,0,0,0
0,0,0,2,101,0,0,0,0
0,0,0,2,101,0,0,0,0
0,0,0,2,101,0,0,0,0
0,0,0,2,101,0,0,0,0
0,0,0,2,101,0,0,0,0
0,0,0,2,101,0,0,0,0
0,0,0,2,101,0,0,0,0
0,0,0,2,101,0,0,0,0
0,0,0,2,101,0,0,0,0
0,0,0,2,101,0,0,0,0
0,0,0,2,101,0,0,0,0
0,0,0,2,101,0,0,0,0
0,0,0,2,101,0,0,0,0
0,0,0,2,101,0,0,0,0
0,0,0,2,101,0,0,0,0
0,0,0,2,101,0,0,0,0
0,0,0,2,101,0,0,0,0
0,0,0,2,101,0,0,0,0
0,0,0,2,101,0,0,0,0
0,0,0,2,101,0,0,0,0
0,0,0,2,101,0,0,0,0
0,0,0,2,101,0,0,0,0
0,0,0,2,101,0,0,0,0
0,0,0,2,101,0,0,0,0
0,0,0,2,101,0,0,0,0
0,0,0,2,101,0,0,0,0
0,0,0,2,101,0,0,0,0
0,0,0,2,101,0,0,0,0
0,0,0,2,101,0,0,0,0
0,0,0,2,101,0,0,0,0
0,0,0,2,101,0,0,0,0
0,0,0,2,101,0,0,0,0
0,0,0,2,101,0,0,0,0
0,0,0,2,101,0,0,0,0
0,0,0,2,101,0,0,0,0
0,0,0,2,101,0,0,0,0
0,0,0,2,101,0,0,0,0
0,0,0,2,101,0,0,0,0
0,0,0,2,101,0,0,0,0
0,0,0,2,101,0,0,0,0
0,0,0,2,101,0,0,0,0
0,0,0,2,101,0,0,0,0
0,0,0,2,101,0,0,0,0
0,0,0,2,101,0,0,0,0
0,0,0,2,101,0,0,0,0
0,0,0,2,101,0,0,0,0
0,0,0,2,101,0,0,0,0
0,0,0,2,101,0,0,0,0
0,0,0,2,101,0,0,0,0
0,0,0,2,101,0,0,0,0
0,0,0,2,101,0,0,0,0
0,0,0,2,101,0,0,0,0
0,0,0,2,101,0,0,0,0
0,0,0,2,101,0,0,0,0
0,0,0,2,101,0,0,0,0
0,0,0,2,101,0,0,0,0
0,0,0,2,101,0,0,0,0
0,0,0,2,101,0,0,0,0
0,0,0,2,101,0,0,0,0
0,0,0,2,101,0,0,0,0
0,0,0,2,101,0,0,0,0
0,0,0,2,101,0,0,0,0
0,0,0,2,101,0,0,0,0
0,0,0,2,101,0,0,0,0
0,0,0,2,101,0,0,0,0
0,0,0,2,101,0,0,0,0
0,0,0,2,101,0,0,0,0
0,0,0,2,101,0,0,0,0
0,0,0,2,101,0,0,0,0
0,0,0,2,101,0,0,0,0
0,0,0,2,101,0,0,0,0
0,0,0,2,101,0,0,0,0
0,0,0,2,101,0,0,0,0
0,0,0,2,101,0,0,0,0
0,0,0,2,101,0,0,0,0
0,0,0,2,101,0,0,0,0
0,0,0,2,101,0,0,0,0
0,0,0,2,101,0,0,0,0
0,0,0,2,101,0,0,0,0
0,0,0,2,101,0,0,0,0
0,0,0,2,101,0,0,0,0
0,0,0,2,101,0,0,0,0
0,0,0,2,101,0,0,0,0
0,0,0,2,101,0,0,0,0
0,0,0,2,101,0,0,0,0
0,0,0,2,101,0,0,0,0
0,0,0,2,101,0,0,0,0
0,0,0,2,101,0,0,0,0
0,0,0,2,101,0,0,0,0
0,0,0,2,101,0,0,0,0
0,0,0,2,101,0,0,0,0
0,0,0,2,101,0,0,0,0
0,0,0,2,101,0,0,0,0
0,0,0,2,101,0,0,0,0
0,0,0,2,101,0,0,0,0
0,0,0,2,101,0,0,0,0
0,0,0,2,101,0,0,0,0
0,0,0,2,101,0,0,0,0
0,0,0,2,101,0,0,0,0
0,0,0,2,101,0,0,0,0
0,0,0,2,101,0,0,0,0
0,0,0,2,101,0,0,0,0
0,0,0,2,101,0,0,0,0
0,0,0,2,101,0,0,0,0
0,0,0,2,101,0,0,0,0
0,0,0,2,101,0,0,0,0
0,0,0,2,101,0,0,0,0
0,0,0,2,101,0,0,0,0
0,0,0,2,101,0,0,0,0
0,0,0,2,101,0,0,0,0
0,0,0,2,101,0,0,0,0
0,0,0,2,101,0,0,0,0
0,0,0,2,101,0,0,0,0
0,0,0,2,101,0,0,0,0
0,0,0,2,101,0,0,0,0
0,0,0,2,101,0,0,0,0
0,0,0,2,101,0,0,0,0
0,0,0,2,101,0,0,0,0
0,0,0,2,101,0,0,0,0
0,0,0,2,101,0,0,0,0
0,0,0,2,101,0,0,0,0
0,0,0,2,101,0,0,0,0
0,0,0,2,101,0,0,0,0
0,0,0,2,101,0,0,0,0
0,0,0,2,101,0,0,0,0
0,0,0,2,101,0,0,0,0
0,0,0,2,101,0,0,0,0
0,0,0,2,101,0,0,0,0
0,0,0,2,101,0,0,0,0
0,0,0,2,101,0,0,0,0
0,0,0,2,101,0,0,0,0
0,0,0,2,101,0,0,0,0
0,0,0,2,101,0,0,0,0
0,0,0,2,101,0,0,0,0
0,0,0,2,101,0,0,0,0
0,0,0,2,101,0,0,0,0
0,0,0,2,101,0,0,0,0
0,0,0,2,101,0,0,0,0
0,0,0,2,101,0,0,0,0
0,0,0,2,101,0,0,0,0
0,0,0,2,101,0,0,0,0
0,0,0,2,101,0,0,0,0
0,0,0,2,101,0,0,0,0
0,0,0,2,101,0,0,0,0
0,0,0,2,101,0,0,0,0
0,0,0,2,101,0,0,0,0
0,0,0,2,101,0,0,0,0
0,0,0,2,101,0,0,0,0
0,0,0,2,101,0,0,0,0
0,0,0,2,101,0,0,0,0
0,0,0,2,101,0,0,0,0
0,0,0,2,101,0,0,0,0
0,0,0,2,101,0,0,0,0
0,0,0,2,101,0,0,0,0
0,0,0,2,101,0,0,0,0
0,0,0,2,101,0,0,0,0
0,0,0,2,101,0,0,0,0
0,0,0,2,101,0,0,0,0
0,0,0,2,101,0,0,0,0
0,0,0,2,101,0,0,0,0
0,0,0,2,101,0,0,0,0
0,0,0,2,101,0,0,0,0
0,0,0,2,101,0,0,0,0
0,0,0,2,101,0,0,0,0
0,0,0,2,101,0,0,0,0
0,0,0,2,101,0,0,0,0
0,0,0,2,101,0,0,0,0
0,0,0,2,101,0,0,0,0
0,0,0,2,101,0,0,0,0
0,0,0,2,101,0,0,0,0
0,0,0,2,101,0,0,0,0
0,0,0,2,101,0,0,0,0
0,0,0,2,101,0,0,0,0
0,0,0,2,101,0,0,0,0
0,0,0,2,101,0,0,0,0
0,0,0,2,101,0,0,0,0
0,0,0,2,101,0,0,0,0
0,0,0,2,101,0,0,0,0
0,0,0,2,101,0,0,0,0
0,0,0,2,101,0,0,0,0
0,0,0,2,101,0,0,0,0
0,0,0,2,101,0,0,0,0
0,0,0,2,101,0,0,0,0
0,0,0,2,101,0,0,0,0
0,0,0,2,101,0,0,0,0
0,0,0,2,101,0,0,0,0
0,0,0,2,101,0,0,0,0
0,0,0,2,101,0,0,0,0
0,0,0,2,101,0,0,0,0
0,0,0,2,101,0,0,0,0
0,0,0,2,101,0,0,0,0
0,0,0,2,101,0,0,0,0
0,0,0,2,101,0,0,0,0
0,0,0,2,101,0,0,0,0
0,0,0,2,101,0,0,0,0
0,0,0,2,101,0,0,0,0
0,0,0,2,101,0,0,0,0
0,0,0,2,101,0,0,0,0
0,0,0,2,101,0,0,0,0
0,0,0,2,101,0,0,0,0
0,0,0,2,101,0,0,0,0
0,0,0,2,101,0,0,0,0
0,0,0,2,101,0,0,0,0
0,0,0,2,101,0,0,0,0
0,0,0,2,101,0,0,0,0
0,0,0,2,101,0,0,0,0
0,0,0,2,101,0,0,0,0
0,0,0,2,101,0,0,0,0
0,0,0,2,101,0,0,0,0
0,0,0,2,101,0,0,0,0
0,0,0,2,101,0,0,0,0
0,0,0,2,101,0,0,0,0
0,0,0,2,101,0,0,0,0
0,0,0,2,101,0,0,0,0
0,0,0,2,101,0,0,0,0
0,0,0,2,101,0,0,0,0
0,0,0,2,101,0,0,0,0
0,0,0,2,101,0,0,0,0
0,0,0,2,101,0,0,0,0
0,0,0,2,101,0,0,0,0
0,0,0,2,101,0,0,0,0
0,0,0,2,101,0,0,0,0
0,0,0,2,101,0,0,0,0
0,0,0,2,101,0,0,0,0
0,0,0,2,101,0,0,0,0
0,0,0,2,101,0,0,0,0
0,0,0,2,101,0,0,0,0
0,0,0,2,101,0,0,0,0
0,0,0,2,101,0,0,0,0
0,0,0,2,101,0,0,0,0
0,0,0,2,101,0,0,0,0
0,0,0,2,101,0,0,0,0
0,0,0,2,101,0,0,0,0
0,0,0,2,101,0,0,0,0
0,0,0,2,101,0,0,0,0
0,0,0,2,101,0,0,0,0
0,0,0,2,101,0,0,0,0
0,0,0,2,101,0,0,0,0
0,0,0,2,101,0,0,0,0
0,0,0,2,101,0,0,0,0
0,0,0,2,101,0,0,0,0
0,0,0,2,101,0,0,0,0
0,0,0,2,101,0,0,0,0
0,0,0,2,101,0,0,0,0
0,0,0,2,101,0,0,0,0
0,0,0,2,101,0,0,0,0
0,0,0,2,101,0,0,0,0
0,0,0,2,101,0,0,0,0
0,0,0,2,101,0,0,0,0
0,0,0,2,101,0,0,0,0
0,0,0,2,101,0,0,0,0
0,0,0,2,101,0,0,0,0
0,0,0,2,101,0,0,0,0
0,0,0,2,101,0,0,0,0
0,0,0,2,101,0,0,0,0
0,0,0,2,101,0,0,0,0
0,0,0,2,101,0,0,0,0
0,0,0,2,101,0,0,0,0
0,0,0,2,101,0,0,0,0
0,0,0,2,101,0,0,0,0
0,0,0,2,101,0,0,0,0
0,0,0,2,101,0,0,0,0
0,0,0,2,101,0,0,0,0
0,0,0,2,101,0,0,0,0
0,0,0,2,101,0,0,0,0
0,0,0,2,101,0,0,0,0
0,0,0,2,101,0,0,0,0
0,0,0,2,101,0,0,0,0
0,0,0,2,101,0,0,0,0
0,0,0,2,101,0,0,0,0
0,0,0,2,101,0,0,0,0
0,0,0,2,101,0,0,0,0
0,0,0,2,101,0,0,0,0
0,0,0,2,101,0,0,0,0
0,0,0,2,101,0,0,0,0
0,0,0,2,101,0,0,0,0
0,0,0,2,101,0,0,0,0
0,0,0,2,101,0,0,0,0
0,0,0,2,101,0,0,0,0
0,0,0,2,101,0,0,0,0
0,0,0,2,101,0,0,0,0
0,0,0,2,101,0,0,0,0
0,0,0,2,101,0,0,0,0
0,0,0,2,101,0,0,0,0
0,0,0,2,101,0,0,0,0
0,0,0,2,101,0,0,0,0
0,0,0,2,101,0,0,0,0
0,0,0,2,101,0,0,0,0
0,0,0,2,101,0,0,0,0
0,0,0,2,101,0,0,0,0
0,0,0,2,101,0,0,0,0
0,0,0,2,101,0,0,0,0
0,0,0,2,101,0,0,0,0
0,0,0,2,101,0,0,0,0
0,0,0,2,101,0,0,0,0
0,0,0,2,101,0,0,0,0
0,0,0,2,101,0,0,0,0
0,0,0,2,101,0,0,0,0
0,0,0,2,101,0,0,0,0
0,0,0,2,101,0,0,0,0
0,0,0,2,101,0,0,0,0
0,0,0,2,101,0,0,0,0
0,0,0,2,101,0,0,0,0
0,0,0,2,101,0,0,0,0
0,0,0,2,101,0,0,0,0
0,0,0,2,101,0,0,0,0
0,0,0,2,101,0,0,0,0
0,0,0,2,101,0,0,0,0
0,0,0,2,101,0,0,0,0
0,0,0,2,101,0,0,0,0
0,0,0,2,101,0,0,0,0
0,0,0,2,101,0,0,0,0
0,0,0,2,101,0,0,0,0
0,0,0,2,101,0,0,0,0
0,0,0,2,101,0,0,0,0
0,0,0,2,101,0,0,0,0
0,0,0,2,101,0,0,0,0
0,0,0,2,101,0,0,0,0
0,0,0,2,101,0,0,0,0
0,0,0,2,101,0,0,0,0
0,0,0,2,101,0,0,0,0
0,0,0,2,101,0,0,0,0
0,0,0,2,101,0,0,0,0
0,0,0,2,101,0,0,0,0
0,0,0,2,101,0,0,0,0
0,0,0,2,101,0,0,0,0
0,0,0,2,101,0,0,0,0
0,0,0,2,101,0,0,0,0
0,0,0,2,101,0,0,0,0
0,0,0,2,101,0,0,0,0
0,0,0,2,101,0,0,0,0
0,0,0,2,101,0,0,0,0
0,0,0,2,101,0,0,0,0
0,0,0,2,101,0,0,0,0
0,0,0,2,101,0,0,0,0
0,0,0,2,101,0,0,0,0
0,0,0,2,101,0,0,0,0
0,0,0,2,101,0,0,0,0
0,0,0,2,101,0,0,0,0
0,0,0,2,101,0,0,0,0
0,0,0,2,101,0,0,0,0
0,0,0,2,101,0,0,0,0
0,0,0,2,101,0,0,0,0
0,0,0,2,101,0,0,0,0
0,0,0,2,101,0,0,0,0
0,0,0,2,101,0,0,0,0
0,0,0,2,101,0,0,0,0
0,0,0,2,101,0,0,0,0
0,0,0,2,101,0,0,0,0
0,0,0,2,101,0,0,0,0
0,0,0,2,101,0,0,0,0
0,0,0,2,101,0,0,0,0
0,0,0,2,101,0,0,0,0
0,0,0,2,101,0,0,0,0
0,0,0,2,101,0,0,0,0
0,0,0,2,101,0,0,0,0
0,0,0,2,101,0,0,0,0
0,0,0,2,101,0,0,0,0
0,0,0,2,101,0,0,0,0
0,0,0,2,101,0,0,0,0
0,0,0,2,101,0,0,0,0
0,0,0,2,101,0,0,0,0
0,0,0,2,101,0,0,0,0
0,0,0,2,101,0,0,0,0
0,0,0,2,101,0,0,0,0
0,0,0,2,101,0,0,0,0
0,0,0,2,101,0,0,0,0
0,0,0,2,101,0,0,0,0
0,0,0,2,101,0,0,0,0
0,0,0,2,101,0,0,0,0
0,0,0,2,101,0,0,0,0
0,0,0,2,101,0,0,0,0
0,0,0,2,101,0,0,0,0
0,0,0,2,101,0,0,0,0
0,0,0,2,101,0,0,0,0
0,0,0,2,101,0,0,0,0
0,0,0,2,101,0,0,0,0
0,0,0,2,101,0,0,0,0
0,0,0,2,101,0,0,0,0
0,0,0,2,101,0,0,0,0
0,0,0,2,101,0,0,0,0
0,0,0,2,101,0,0,0,0
0,0,0,2,101,0,0,0,0
0,0,0,2,101,0,0,0,0
0,0,0,2,101,0,0,0,0
0,0,0,2,101,0,0,0,0
0,0,0,2,101,0,0,0,0
0,0,0,2,101,0,0,0,0
0,0,0,2,101,0,0,0,0
0,0,0,2,101,0,0,0,0
0,0,0,2,101,0,0,0,0
0,0,0,2,101,0,0,0,0
0,0,0,2,101,0,0,0,0
0,0,0,2,101,0,0,0,0
0,0,0,2,101,0,0,0,0
0,0,0,2,101,0,0,0,0
0,0,0,2,101,0,0,0,0
0,0,0,2,101,0,0,0,0
0,0,0,2,101,0,0,0,0
0,0,0,2,101,0,0,0,0
0,0,0,2,101,0,0,0,0
0,0,0,2,101,0,0,0,0
0,0,0,2,101,0,0,0,0
0,0,0,2,101,0,0,0,0
0,0,0,2,101,0,0,0,0
0,0,0,2,101,0,0,0,0
0,0,0,2,101,0,0,0,0
0,0,0,2,101,0,0,0,0
0,0,0,2,101,0,0,0,0
0,0,0,2,101,0,0,0,0
0,0,0,2,101,0,0,0,0
0,0,0,2,101,0,0,0,0
0,0,0,2,101,0,0,0,0
0,0,0,2,101,0,0,0,0
0,0,0,2,101,0,0,0,0
0,0,0,2,101,0,0,0,0
0,0,0,2,101,0,0,0,0
0,0,0,2,101,0,0,0,0
0,0,0,2,101,0,0,0,0
0,0,0,2,101,0,0,0,0
0,0,0,2,101,0,0,0,0
0,0,0,2,101,0,0,0,0
0,0,0,2,101,0,0,0,0
0,0,0,2,101,0,0,0,0
0,0,0,2,101,0,0,0,0
0,0,0,2,101,0,0,0,0
0,0,0,2,101,0,0,0,0
0,0,0,2,101,0,0,0,0
0,0,0,2,101,0,0,0,0
0,0,0,2,101,0,0,0,0
0,0,0,2,101,0,0,0,0
0,0,0,2,101,0,0,0,0
0,0,0,2,101,0,0,0,0
0,0,0,2,101,0,0,0,0
0,0,0,2,101,0,0,0,0
0,0,0,2,101,0,0,0,0
0,0,0,2,101,0,0,0,0
0,0,0,2,101,0,0,0,0
0,0,0,2,101,0,0,0,0
0,0,0,2,101,0,0,0,0
0,0,0,2,101,0,0,0,0
0,0,0,2,101,0,0,0,0
0,0,0,2,101,0,0,0,0
0,0,0,2,101,0,0,0,0
0,0,0,2,101,0,0,0,0
0,0,0,2,101,0,0,0,0
0,0,0,2,101,0,0,0,0
0,0,0,2,101,0,0,0,0
0,0,0,2,101,0,0,0,0
0,0,0,2,101,0,0,0,0
0,0,0,2,101,0,0,0,0
0,0,0,2,101,0,0,0,0
0,0,0,2,101,0,0,0,0
0,0,0,2,101,0,0,0,0
0,0,0,2,101,0,0,0,0
0,0,0,2,101,0,0,0,0
0,0,0,2,101,0,0,0,0
0,0,0,2,101,0,0,0,0
0,0,0,2,101,0,0,0,0
0,0,0,2,101,0,0,0,0
0,0,0,2,101,0,0,0,0
0,0,0,2,101,0,0,0,0
0,0,0,2,101,0,0,0,0
0,0,0,2,101,0,0,0,0
0,0,0,2,101,0,0,0,0
0,0,0,2,101,0,0,0,0
0,0,0,2,101,0,0,0,0
0,0,0,2,101,0,0,0,0
0,0,0,2,101,0,0,0,0
0,0,0,2,101,0,0,0,0
0,0,0,2,101,0,0,0,0
0,0,0,2,101,0,0,0,0
0,0,0,2,101,0,0,0,0
0,0,0,2,101,0,0,0,0
0,0,0,2,101,0,0,0,0
0,0,0,2,101,0,0,0,0
0,0,0,2,101,0,0,0,0
0,0,0,2,101,0,0,0,0
0,0,0,2,101,0,0,0,0
0,0,0,2,101,0,0,0,0
0,0,0,2,101,0,0,0,0
0,0,0,2,101,0,0,0,0
0,0,0,2,101,0,0,0,0
0,0,0,2,101,0,0,0,0
0,0,0,2,101,0,0,0,0
0,0,0,2,101,0,0,0,0
0,0,0,2,101,0,0,0,0
0,0,0,2,101,0,0,0,0
0,0,0,2,101,0,0,0,0
0,0,0,2,101,0,0,0,0
0,0,0,2,101,0,0,0,0
0,0,0,2,101,0,0,0,0
0,0,0,2,101,0,0,0,0
0,0,0,2,101,0,0,0,0
0,0,0,2,101,0,0,0,0
0,0,0,2,101,0,0,0,0
0,0,0,2,101,0,0,0,0
0,0,0,2,101,0,0,0,0
0,0,0,2,101,0,0,0,0
0,0,0,2,101,0,0,0,0
0,0,0,2,101,0,0,0,0
0,0,0,2,101,0,0,0,0
0,0,0,2,101,0,0,0,0
0,0,0,2,101,0,0,0,0
0,0,0,2,101,0,0,0,0
0,0,0,2,101,0,0,0,0
0,0,0,2,101,0,0,0,0
0,0,0,2,101,0,0,0,0
0,0,0,2,101,0,0,0,0
0,0,0,2,101,0,0,0,0
0,0,0,2,101,0,0,0,0
0,0,0,2,101,0,0,0,0
0,0,0,2,101,0,0,0,0
0,0,0,2,101,0,0,0,0
0,0,0,2,101,0,0,0,0
0,0,0,2,101,0,0,0,0
0,0,0,2,101,0,0,0,0
0,0,0,2,101,0,0,0,0
0,0,0,2,101,0,0,0,0
0,0,0,2,101,0,0,0,0
0,0,0,2,101,0,0,0,0
0,0,0,2,101,0,0,0,0
0,0,0,2,101,0,0,0,0
0,0,0,2,101,0,0,0,0
0,0,0,2,101,0,0,0,0
0,0,0,2,101,0,0,0,0
0,0,0,2,101,0,0,0,0
0,0,0,2,101,0,0,0,0
0,0,0,2,101,0,0,0,0
0,0,0,2,101,0,0,0,0
0,0,0,2,101,0,0,0,0
0,0,0,2,101,0,0,0,0
0,0,0,2,101,0,0,0,0
0,0,0,2,101,0,0,0,0
0,0,0,2,101,0,0,0,0
0,0,0,2,101,0,0,0,0
0,0,0,2,101,0,0,0,0
0,0,0,2,101,0,0,0,0
0,0,0,2,101,0,0,0,0
0,0,0,2,101,0,0,0,0
0,0,0,2,101,0,0,0,0
0,0,0,2,101,0,0,0,0
0,0,0,2,101,0,0,0,0
0,0,0,2,101,0,0,0,0
0,0,0,2,101,0,0,0,0
0,0,0,2,101,0,0,0,0
0,0,0,2,101,0,0,0,0
0,0,0,2,101,0,0,0,0
0,0,0,2,101,0,0,0,0
0,0,0,2,101,0,0,0,0
0,0,0,2,101,0,0,0,0
0,0,0,2,101,0,0,0,0
0,0,0,2,101,0,0,0,0
0,0,0,2,101,0,0,0,0
0,0,0,2,101,0,0,0,0
0,0,0,2,101,0,0,0,0
0,0,0,2,101,0,0,0,0
0,0,0,2,101,0,0,0,0
0,0,0,2,101,0,0,0,0
0,0,0,2,101,0,0,0,0
0,0,0,2,101,0,0,0,0
0,0,0,2,101,0,0,0,0
0,0,0,2,101,0,0,0,0
0,0,0,2,101,0,0,0,0
0,0,0,2,101,0,0,0,0
0,0,0,2,101,0,0,0,0
0,0,0,2,101,0,0,0,0
0,0,0,2,101,0,0,0,0
0,0,0,2,101,0,0,0,0
0,0,0,2,101,0,0,0,0
0,0,0,2,101,0,0,0,0
0,0,0,2,101,0,0,0,0
0,0,0,2,101,0,0,0,0
0,0,0,2,101,0,0,0,0
0,0,0,2,101,0,0,0,0
0,0,0,2,101,0,0,0,0
0,0,0,2,101,0,0,0,0
0,0,0,2,101,0,0,0,0
0,0,0,2,101,0,0,0,0
0,0,0,2,101,0,0,0,0
0,0,0,2,101,0,0,0,0
0,0,0,2,101,0,0,0,0
0,0,0,2,101,0,0,0,0
0,0,0,2,101,0,0,0,0
0,0,0,2,101,0,0,0,0
0,0,0,2,101,0,0,0,0
0,0,0,2,101,0,0,0,0
0,0,0,2,101,0,0,0,0
0,0,0,2,101,0,0,0,0
0,0,0,2,101,0,0,0,0
0,0,0,2,101,0,0,0,0
0,0,0,2,101,0,0,0,0
0,0,0,2,101,0,0,0,0
0,0,0,2,101,0,0,0,0
0,0,0,2,101,0,0,0,0
0,0,0,2,101,0,0,0,0
0,0,0,2,101,0,0,0,0
0,0,0,2,101,0,0,0,0
0,0,0,2,101,0,0,0,0
0,0,0,2,101,0,0,0,0
0,0,0,2,101,0,0,0,0
0,0,0,2,101,0,0,0,0
0,0,0,2,101,0,0,0,0
0,0,0,2,101,0,0,0,0
0,0,0,2,101,0,0,0,0
0,0,0,2,101,0,0,0,0
0,0,0,2,101,0,0,0,0
0,0,0,2,101,0,0,0,0
0,0,0,2,101,0,0,0,0
0,0,0,2,101,0,0,0,0
0,0,0,2,101,0,0,0,0
0,0,0,2,101,0,0,0,0
0,0,0,2,101,0,0,0,0
0,0,0,2,101,0,0,0,0
0,0,0,2,101,0,0,0,0
0,0,0,2,101,0,0,0,0
0,0,0,2,101,0,0,0,0
0,0,0,2,101,0,0,0,0
0,0,0,2,101,0,0,0,0
0,0,0,2,101,0,0,0,0
0,0,0,2,101,0,0,0,0
0,0,0,2,101,0,0,0,0
0,0,0,2,101,0,0,0,0
0,0,0,2,101,0,0,0,0
0,0,0,2,101,0,0,0,0
0,0,0,2,101,0,0,0,0
0,0,0,2,101,0,0,0,0
0,0,0,2,101,0,0,0,0
0,0,0,2,101,0,0,0,0
0,0,0,2,101,0,0,0,0
0,0,0,2,101,0,0,0,0
0,0,0,2,101,0,0,0,0
0,0,0,2,101,0,0,0,0
0,0,0,2,101,0,0,0,0
0,0,0,2,101,0,0,0,0
0,0,0,2,101,0,0,0,0
0,0,0,2,101,0,0,0,0
0,0,0,2,101,0,0,0,0
0,0,0,2,101,0,0,0,0
0,0,0,2,101,0,0,0,0
0,0,0,2,101,0,0,0,0
0,0,0,2,101,0,0,0,0
0,0,0,2,101,0,0,0,0
0,0,0,2,101,0,0,0,0
0,0,0,2,101,0,0,0,0
0,0,0,2,101,0,0,0,0
0,0,0,2,101,0,0,0,0
0,0,0,2,101,0,0,0,0
0,0,0,2,101,0,0,0,0
0,0,0,2,101,0,0,0,0
0,0,0,2,101,0,0,0,0
0,0,0,2,101,0,0,0,0
0,0,0,2,101,0,0,0,0
0,0,0,2,101,0,0,0,0
0,0,0,2,101,0,0,0,0
0,0,0,2,101,0,0,0,0
0,0,0,2,101,0,0,0,0
0,0,0,2,101,0,0,0,0
0,0,0,2,101,0,0,0,0
0,0,0,2,101,0,0,0,0
0,0,0,2,101,0,0,0,0
0,0,0,2,101,0,0,0,0
0,0,0,2,101,0,0,0,0
0,0,0,2,101,0,0,0,0
0,0,0,2,101,0,0,0,0
0,0,0,2,101,0,0,0,0
0,0,0,2,101,0,0,0,0
0,0,0,2,101,0,0,0,0
0,0,0,2,101,0,0,0,0
0,0,0,2,101,0,0,0,0
0,0,0,2,101,0,0,0,0
0,0,0,2,101,0,0,0,0
0,0,0,2,101,0,0,0,0
0,0,0,2,101,0,0,0,0
0,0,0,2,101,0,0,0,0
0,0,0,2,101,0,0,0,0
0,0,0,2,101,0,0,0,0
0,0,0,2,101,0,0,0,0
0,0,0,2,101,0,0,0,0
0,0,0,2,101,0,0,0,0
0,0,0,2,101,0,0,0,0
0,0,0,2,101,0,0,0,0
0,0,0,2,101,0,0,0,0
0,0,0,2,101,0,0,0,0
0,0,0,2,101,0,0,0,0
0,0,0,2,101,0,0,0,0
0,0,0,2,101,0,0,0,0
0,0,0,2,101,0,0,0,0
0,0,0,2,101,0,0,0,0
0,0,0,2,101,0,0,0,0
0,0,0,2,101,0,0,0,0
0,0,0,2,101,0,0,0,0
0,0,0,2,101,0,0,0,0
0,0,0,2,101,0,0,0,0
0,0,0,2,101,0,0,0,0
0,0,0,2,101,0,0,0,0
0,0,0,2,101,0,0,0,0
0,0,0,2,101,0,0,0,0
0,0,0,2,101,0,0,0,0
0,0,0,2,101,0,0,0,0
0,0,0,2,101,0,0,0,0
0,0,0,2,101,0,0,0,0
0,0,0,2,101,0,0,0,0
0,0,0,2,101,0,0,0,0
0,0,0,2,101,0,0,0,0
0,0,0,2,101,0,0,0,0
0,0,0,2,101,0,0,0,0
0,0,0,2,101,0,0,0,0
0,0,0,2,101,0,0,0,0
0,0,0,2,101,0,0,0,0
0,0,0,2,101,0,0,0,0
0,0,0,2,101,0,0,0,0
0,0,0,2,101,0,0,0,0
0,0,0,2,101,0,0,0,0
0,0,0,2,101,0,0,0,0
0,0,0,2,101,0,0,0,0
0,0,0,2,101,0,0,0,0
0,0,0,2,101,0,0,0,0
0,0,0,2,101,0,0,0,0
0,0,0,2,101,0,0,0,0
0,0,0,2,101,0,0,0,0
0,0,0,2,101,0,0,0,0
0,0,0,2,101,0,0,0,0
0,0,0,2,101,0,0,0,0
0,0,0,2,101,0,0,0,0
0,0,0,2,101,0,0,0,0
0,0,0,2,101,0,0,0,0
0,0,0,2,101,0,0,0,0
0,0,0,2,101,0,0,0,0
0,0,0,2,101,0,0,0,0
0,0,0,2,101,0,0,0,0
0,0,0,2,101,0,0,0,0
0,0,0,2,101,0,0,0,0
0,0,0,2,101,0,0,0,0
0,0,0,2,101,0,0,0,0
0,0,0,2,101,0,0,0,0
0,0,0,2,101,0,0,0,0
0,0,0,2,101,0,0,0,0
0,0,0,2,101,0,0,0,0
0,0,0,2,101,0,0,0,0
0,0,0,2,101,0,0,0,0
0,0,0,2,101,0,0,0,0
0,0,0,2,101,0,0,0,0
0,0,0,2,101,0,0,0,0
0,0,0,2,101,0,0,0,0
0,0,0,2,101,0,0,0,0
0,0,0,2,101,0,0,0,0
0,0,0,2,101,0,0,0,0
0,0,0,2,101,0,0,0,0
0,0,0,2,101,0,0,0,0
0,0,0,2,101,0,0,0,0
0,0,0,2,101,0,0,0,0
0,0,0,2,101,0,0,0,0
0,0,0,2,101,0,0,0,0
0,0,0,2,101,0,0,0,0
0,0,0,2,101,0,0,0,0
0,0,0,2,101,0,0,0,0
0,0,0,2,101,0,0,0,0
0,0,0,2,101,0,0,0,0
0,0,0,2,101,0,0,0,0
0,0,0,2,101,0,0,0,0
0,0,0,2,101,0,0,0,0
0,0,0,2,101,0,0,0,0
0,0,0,2,101,0,0,0,0
0,0,0,2,101,0,0,0,0
0,0,0,2,101,0,0,0,0
0,0,0,2,101,0,0,0,0
0,0,0,2,101,0,0,0,0
0,0,0,2,101,0,0,0,0
0,0,0,2,101,0,0,0,0
0,0,0,2,101,0,0,0,0
0,0,0,2,101,0,0,0,0
0,0,0,2,101,0,0,0,0
0,0,0,2,101,0,0,0,0
0,0,0,2,101,0,0,0,0
0,0,0,2,101,0,0,0,0
0,0,0,2,101,0,0,0,0
0,0,0,2,101,0,0,0,0
0,0,0,2,101,0,0,0,0
0,0,0,2,101,0,0,0,0
0,0,0,2,101,0,0,0,0
0,0,0,2,101,0,0,0,0
0,0,0,2,101,0,0,0,0
0,0,0,2,101,0,0,0,0
0,0,0,2,101,0,0,0,0
0,0,0,2,101,0,0,0,0
0,0,0,2,101,0,0,0,0
0,0,0,2,101,0,0,0,0
0,0,0,2,101,0,0,0,0
0,0,0,2,101,0,0,0,0
0,0,0,2,101,0,0,0,0
0,0,0,2,101,0,0,0,0
0,0,0,2,101,0,0,0,0
0,0,0,2,101,0,0,0,0
0,0,0,2,101,0,0,0,0
0,0,0,2,101,0,0,0,0
0,0,0,2,101,0,0,0,0
0,0,0,2,101,0,0,0,0
0,0,0,2,101,0,0,0,0
0,0,0,2,101,0,0,0,0
0,0,0,2,101,0,0,0,0
0,0,0,2,101,0,0,0,0
0,0,0,2,101,0,0,0,0
0,0,0,2,101,0,0,0,0
0,0,0,2,101,0,0,0,0
0,0,0,2,101,0,0,0,0
0,0,0,2,101,0,0,0,0
0,0,0,2,101,0,0,0,0
0,0,0,2,101,0,0,0,0
0,0,0,2,101,0,0,0,0
0,0,0,2,101,0,0,0,0
0,0,0,2,101,0,0,0,0
0,0,0,2,101,0,0,0,0
0,0,0,2,101,0,0,0,0
0,0,0,2,101,0,0,0,0
0,0,0,2,101,0,0,0,0
0,0,0,2,101,0,0,0,0
0,0,0,2,101,0,0,0,0
0,0,0,2,101,0,0,0,0
0,0,0,2,101,0,0,0,0
0,0,0,2,101,0,0,0,0
0,0,0,2,101,0,0,0,0
0,0,0,2,101,0,0,0,0
0,0,0,2,101,0,0,0,0
0,0,0,2,101,0,0,0,0
0,0,0,2,101,0,0,0,0
0,0,0,2,101,0,0,0,0
0,0,0,2,101,0,0,0,0
0,0,0,2,101,0,0,0,0
0,0,0,2,101,0,0,0,0
0,0,0,2,101,0,0,0,0
0,0,0,2,101,0,0,0,0
0,0,0,2,101,0,0,0,0
0,0,0,2,101,0,0,0,0
0,0,0,2,101,0,0,0,0
0,0,0,2,101,0,0,0,0
0,0,0,2,101,0,0,0,0
0,0,0,2,101,0,0,0,0
0,0,0,2,101,0,0,0,0
0,0,0,2,101,0,0,0,0
0,0,0,2,101,0,0,0,0
0,0,0,2,101,0,0,0,0
0,0,0,2,101,0,0,0,0
0,0,0,2,101,0,0,0,0
0,0,0,2,101,0,0,0,0
0,0,0,2,101,0,0,0,0
0,0,0,2,101,0,0,0,0
0,0,0,2,101,0,0,0,0
0,0,0,2,101,0,0,0,0
0,0,0,2,101,0,0,0,0
0,0,0,2,101,0,0,0,0
0,0,0,2,101,0,0,0,0
0,0,0,2,101,0,0,0,0
0,0,0,2,101,0,0,0,0
0,0,0,2,101,0,0,0,0
0,0,0,2,101,0,0,0,0
0,0,0,2,101,0,0,0,0
0,0,0,2,101,0,0,0,0
0,0,0,2,101,0,0,0,0
0,0,0,2,101,0,0,0,0
0,0,0,2,101,0,0,0,0
0,0,0,2,101,0,0,0,0
0,0,0,2,101,0,0,0,0
0,0,0,2,101,0,0,0,0
0,0,0,2,101,0,0,0,0
0,0,0,2,101,0,0,0,0
0,0,0,2,101,0,0,0,0
0,0,0,2,101,0,0,0,0
0,0,0,2,101,0,0,0,0
0,0,0,2,101,0,0,0,0
0,0,0,2,101,0,0,0,0
0,0,0,2,101,0,0,0,0
0,0,0,2,101,0,0,0,0
0,0,0,2,101,0,0,0,0
0,0,0,2,101,0,0,0,0
0,0,0,2,101,0,0,0,0
0,0,0,2,101,0,0,0,0
0,0,0,2,101,0,0,0,0
0,0,0,2,101,0,0,0,0
0,0,0,2,101,0,0,0,0
0,0,0,2,101,0,0,0,0
0,0,0,2,101,0,0,0,0
0,0,0,2,101,0,0,0,0
0,0,0,2,101,0,0,0,0
0,0,0,2,101,0,0,0,0
0,0,0,2,101,0,0,0,0
0,0,0,2,101,0,0,0,0
0,0,0,2,101,0,0,0,0
0,0,0,2,101,0,0,0,0
0,0,0,2,101,0,0,0,0
0,0,0,2,101,0,0,0,0
0,0,0,2,101,0,0,0,0
0,0,0,2,101,0,0,0,0
0,0,0,2,101,0,0,0,0
0,0,0,2,101,0,0,0,0
0,0,0,2,101,0,0,0,0
0,0,0,2,101,0,0,0,0
0,0,0,2,101,0,0,0,0
0,0,0,2,101,0,0,0,0
0,0,0,2,101,0,0,0,0
0,0,0,2,101,0,0,0,0
0,0,0,2,101,0,0,0,0
0,0,0,2,101,0,0,0,0
0,0,0,2,101,0,0,0,0
0,0,0,2,101,0,0,0,0
0,0,0,2,101,0,0,0,0
0,0,0,2,101,0,0,0,0
0,0,0,2,101,0,0,0,0
0,0,0,2,101,0,0,0,0
0,0,0,2,101,0,0,0,0
0,0,0,2,101,0,0,0,0
0,0,0,2,101,0,0,0,0
0,0,0,2,101,0,0,0,0
0,0,0,2,101,0,0,0,0
0,0,0,2,101,0,0,0,0
0,0,0,2,101,0,0,0,0
0,0,0,2,101,0,0,0,0
0,0,0,2,101,0,0,0,0
0,0,0,2,101,0,0,0,0
0,0,0,2,101,0,0,0,0
0,0,0,2,101,0,0,0,0
0,0,0,2,101,0,0,0,0
0,0,0,2,101,0,0,0,0
0,0,0,2,101,0,0,0,0
0,0,0,2,101,0,0,0,0
0,0,0,2,101,0,0,0,0
0,0,0,2,101,0,0,0,0
0,0,0,2,101,0,0,0,0
0,0,0,2,101,0,0,0,0
0,0,0,2,101,0,0,0,0
0,0,0,2,101,0,0,0,0
0,0,0,2,101,0,0,0,0
0,0,0,2,101,0,0,0,0
0,0,0,2,101,0,0,0,0
0,0,0,2,101,0,0,0,0
0,0,0,2,101,0,0,0,0
0,0,0,2,101,0,0,0,0
0,0,0,2,101,0,0,0,0
0,0,0,2,101,0,0,0,0
0,0,0,2,101,0,0,0,0
0,0,0,2,101,0,0,0,0
0,0,0,2,101,0,0,0,0
0,0,0,2,101,0,0,0,0
0,0,0,2,101,0,0,0,0
0,0,0,2,101,0,0,0,0
0,0,0,2,101,0,0,0,0
0,0,0,2,101,0,0,0,0
0,0,0,2,101,0,0,0,0
0,0,0,2,101,0,0,0,0
0,0,0,2,101,0,0,0,0
0,0,0,2,101,0,0,0,0
0,0,0,2,101,0,0,0,0
0,0,0,2,101,0,0,0,0
0,0,0,2,101,0,0,0,0
0,0,0,2,101,0,0,0,0
0,0,0,2,101,0,0,0,0
0,0,0,2,101,0,0,0,0
0,0,0,2,101,0,0,0,0
0,0,0,2,101,0,0,0,0
0,0,0,2,101,0,0,0,0
0,0,0,2,101,0,0,0,0
0,0,0,2,101,0,0,0,0
0,0,0,2,101,0,0,0,0
0,0,0,2,101,0,0,0,0
0,0,0,2,101,0,0,0,0
0,0,0,2,101,0,0,0,0
0,0,0,2,101,0,0,0,0
0,0,0,2,101,0,0,0,0
0,0,0,2,101,0,0,0,0
0,0,0,2,101,0,0,0,0
0,0,0,2,101,0,0,0,0
0,0,0,2,101,0,0,0,0
0,0,0,2,101,0,0,0,0
0,0,0,2,101,0,0,0,0
0,0,0,2,101,0,0,0,0
0,0,0,2,101,0,0,0,0
0,0,0,2,101,0,0,0,0
0,0,0,2,101,0,0,0,0
0,0,0,2,101,0,0,0,0
0,0,0,2,101,0,0,0,0
0,0,0,2,101,0,0,0,0
0,0,0,2,101,0,0,0,0
0,0,0,2,101,0,0,0,0
0,0,0,2,101,0,0,0,0
0,0,0,2,101,0,0,0,0
0,0,0,2,101,0,0,0,0
0,0,0,2,101,0,0,0,0
0,0,0,2,101,0,0,0,0
0,0,0,2,101,0,0,0,0
0,0,0,2,101,0,0,0,0
0,0,0,2,101,0,0,0,0
0,0,0,2,101,0,0,0,0
0,0,0,2,101,0,0,0,0
0,0,0,2,101,0,0,0,0
0,0,0,2,101,0,0,0,0
0,0,0,2,101,0,0,0,0
0,0,0,2,101,0,0,0,0
0,0,0,2,101,0,0,0,0
0,0,0,2,101,0,0,0,0
0,0,0,2,101,0,0,0,0
0,0,0,2,101,0,0,0,0
0,0,0,2,101,0,0,0,0
0,0,0,2,101,0,0,0,0
0,0,0,2,101,0,0,0,0
0,0,0,2,101,0,0,0,0
0,0,0,2,101,0,0,0,0
0,0,0,2,101,0,0,0,0
0,0,0,2,101,0,0,0,0
0,0,0,2,101,0,0,0,0
0,0,0,2,101,0,0,0,0
0,0,0,2,101,0,0,0,0
0,0,0,2,101,0,0,0,0
0,0,0,2,101,0,0,0,0
0,0,0,2,101,0,0,0,0
0,0,0,2,101,0,0,0,0
0,0,0,2,101,0,0,0,0
0,0,0,2,101,0,0,0,0
0,0,0,2,101,0,0,0,0
0,0,0,2,101,0,0,0,0
0,0,0,2,101,0,0,0,0
0,0,0,2,101,0,0,0,0
0,0,0,2,101,0,0,0,0
0,0,0,2,101,0,0,0,0
0,0,0,2,101,0,0,0,0
0,0,0,2,101,0,0,0,0
0,0,0,2,101,0,0,0,0
0,0,0,2,101,0,0,0,0
0,0,0,2,101,0,0,0,0
0,0,0,2,101,0,0,0,0
0,0,0,2,101,0,0,0,0
0,0,0,2,101,0,0,0,0
0,0,0,2,101,0,0,0,0
0,0,0,2,101,0,0,0,0
0,0,0,2,101,0,0,0,0
0,0,0,2,101,0,0,0,0
0,0,0,2,101,0,0,0,0
0,0,0,2,101,0,0,0,0
0,0,0,2,101,0,0,0,0
0,0,0,2,101,0,0,0,0
0,0,0,2,101,0,0,0,0
0,0,0,2,101,0,0,0,0
0,0,0,2,101,0,0,0,0
0,0,0,2,101,0,0,0,0
0,0,0,2,101,0,0,0,0
0,0,0,2,101,0,0,0,0
0,0,0,2,101,0,0,0,0
0,0,0,2,101,0,0,0,0
0,0,0,2,101,0,0,0,0
0,0,0,2,101,0,0,0,0
0,0,0,2,101,0,0,0,0
0,0,0,2,101,0,0,0,0
0,0,0,2,101,0,0,0,0
0,0,0,2,101,0,0,0,0
0,0,0,2,101,0,0,0,0
0,0,0,2,101,0,0,0,0
0,0,0,2,101,0,0,0,0
0,0,0,2,101,0,0,0,0
0,0,0,2,101,0,0,0,0
0,0,0,2,101,0,0,0,0
0,0,0,2,101,0,0,0,0
0,0,0,2,101,0,0,0,0
0,0,0,2,101,0,0,0,0
0,0,0,2,101,0,0,0,0
0,0,0,2,101,0,0,0,0
0,0,0,2,101,0,0,0,0
0,0,0,2,101,0,0,0,0
0,0,0,2,101,0,0,0,0
0,0,0,2,101,0,0,0,0
0,0,0,2,101,0,0,0,0
0,0,0,2,101,0,0,0,0
0,0,0,2,101,0,0,0,0
0,0,0,2,101,0,0,0,0
0,0,0,2,101,0,0,0,0
0,0,0,2,101,0,0,0,0
0,0,0,2,101,0,0,0,0
0,0,0,2,101,0,0,0,0
0,0,0,2,101,0,0,0,0
0,0,0,2,101,0,0,0,0
0,0,0,2,101,0,0,0,0
0,0,0,2,101,0,0,0,0
0,0,0,2,101,0,0,0,0
0,0,0,2,101,0,0,0,0
0,0,0,2,101,0,0,0,0
0,0,0,2,101,0,0,0,0
0,0,0,2,101,0,0,0,0
0,0,0,2,101,0,0,0,0
0,0,0,2,101,0,0,0,0
0,0,0,2,101,0,0,0,0
0,0,0,2,101,0,0,0,0
0,0,0,2,101,0,0,0,0
0,0,0,2,101,0,0,0,0
0,0,0,2,101,0,0,0,0
0,0,0,2,101,0,0,0,0
0,0,0,2,101,0,0,0,0
0,0,0,2,101,0,0,0,0
0,0,0,2,101,0,0,0,0
0,0,0,2,101,0,0,0,0
0,0,0,2,101,0,0,0,0
0,0,0,2,101,0,0,0,0
0,0,0,2,101,0,0,0,0
0,0,0,2,101,0,0,0,0
0,0,0,2,101,0,0,0,0
0,0,0,2,101,0,0,0,0
0,0,0,2,101,0,0,0,0
0,0,0,2,101,0,0,0,0
0,0,0,2,101,0,0,0,0
0,0,0,2,101,0,0,0,0
0,0,0,2,101,0,0,0,0
0,0,0,2,101,0,0,0,0
0,0,0,2,101,0,0,0,0
0,0,0,2,101,0,0,0,0
0,0,0,2,101,0,0,0,0
0,0,0,2,101,0,0,0,0
0,0,0,2,101,0,0,0,0
0,0,0,2,101,0,0,0,0
0,0,0,2,101,0,0,0,0
0,0,0,2,101,0,0,0,0
0,0,0,2,101,0,0,0,0
0,0,0,2,101,0,0,0,0
0,0,0,2,101,0,0,0,0
0,0,0,2,101,0,0,0,0
0,0,0,2,101,0,0,0,0
0,0,0,2,101,0,0,0,0
0,0,0,2,101,0,0,0,0
0,0,0,2,101,0,0,0,0
0,0,0,2,101,0,0,0,0
0,0,0,2,101,0,0,0,0
0,0,0,2,101,0,0,0,0
0,0,0,2,101,0,0,0,0
0,0,0,2,101,0,0,0,0
0,0,0,2,101,0,0,0,0
0,0,0,2,101,0,0,0,0
0,0,0,2,101,0,0,0,0
0,0,0,2,101,0,0,0,0
0,0,0,2,101,0,0,0,0
0,0,0,2,101,0,0,0,0
0,0,0,2,101,0,0,0,0
0,0,0,2,101,0,0,0,0
0,0,0,2,101,0,0,0,0
0,0,0,2,101,0,0,0,0
0,0,0,2,101,0,0,0,0
0,0,0,2,101,0,0,0,0
0,0,0,2,101,0,0,0,0
0,0,0,2,101,0,0,0,0
0,0,0,2,101,0,0,0,0
0,0,0,2,101,0,0,0,0
0,0,0,2,101,0,0,0,0
0,0,0,2,101,0,0,0,0
0,0,0,2,101,0,0,0,0
0,0,0,2,101,0,0,0,0
0,0,0,2,101,0,0,0,0
0,0,0,2,101,0,0,0,0
0,0,0,2,101,0,0,0,0
0,0,0,2,101,0,0,0,0
0,0,0,2,101,0,0,0,0
0,0,0,2,101,0,0,0,0
0,0,0,2,101,0,0,0,0
0,0,0,2,101,0,0,0,0
0,0,0,2,101,0,0,0,0
0,0,0,2,101,0,0,0,0
0,0,0,2,101,0,0,0,0
0,0,0,2,101,0,0,0,0
0,0,0,2,101,0,0,0,0
0,0,0,2,101,0,0,0,0
0,0,0,2,101,0,0,0,0
0,0,0,2,101,0,0,0,0
0,0,0,2,101,0,0,0,0
0,0,0,2,101,0,0,0,0
0,0,0,2,101,0,0,0,0
0,0,0,2,101,0,0,0,0
0,0,0,2,101,0,0,0,0
0,0,0,2,101,0,0,0,0
0,0,0,2,101,0,0,0,0
0,0,0,2,101,0,0,0,0
0,0,0,2,101,0,0,0,0
0,0,0,2,101,0,0,0,0
0,0,0,2,101,0,0,0,0
0,0,0,2,101,0,0,0,0
0,0,0,2,101,0,0,0,0
0,0,0,2,101,0,0,0,0
0,0,0,2,101,0,0,0,0
0,0,0,2,101,0,0,0,0
0,0,0,2,101,0,0,0,0
0,0,0,2,101,0,0,0,0
0,0,0,2,101,0,0,0,0
0,0,0,2,101,0,0,0,0
0,0,0,2,101,0,0,0,0
0,0,0,2,101,0,0,0,0
0,0,0,2,101,0,0,0,0
0,0,0,2,101,0,0,0,0
0,0,0,2,101,0,0,0,0
0,0,0,2,101,0,0,0,0
0,0,0,2,101,0,0,0,0
0,0,0,2,101,0,0,0,0
0,0,0,2,101,0,0,0,0
0,0,0,2,101,0,0,0,0
0,0,0,2,101,0,0,0,0
0,0,0,2,101,0,0,0,0
0,0,0,2,101,0,0,0,0
0,0,0,2,101,0,0,0,0
0,0,0,2,101,0,0,0,0
0,0,0,2,101,0,0,0,0
0,0,0,2,101,0,0,0,0
0,0,0,2,101,0,0,0,0
0,0,0,2,101,0,0,0,0
0,0,0,2,101,0,0,0,0
0,0,0,2,101,0,0,0,0
0,0,0,2,101,0,0,0,0
0,0,0,2,101,0,0,0,0
0,0,0,2,101,0,0,0,0
0,0,0,2,101,0,0,0,0
0,0,0,2,101,0,0,0,0
0,0,0,2,101,0,0,0,0
0,0,0,2,101,0,0,0,0
0,0,0,2,101,0,0,0,0
0,0,0,2,101,0,0,0,0
0,0,0,2,101,0,0,0,0
0,0,0,2,101,0,0,0,0
0,0,0,2,101,0,0,0,0
0,0,0,2,101,0,0,0,0
0,0,0,2,101,0,0,0,0
0,0,0,2,101,0,0,0,0
0,0,0,2,101,0,0,0,0
0,0,0,2,101,0,0,0,0
0,0,0,2,101,0,0,0,0
0,0,0,2,101,0,0,0,0
0,0,0,2,101,0,0,0,0
0,0,0,2,101,0,0,0,0
0,0,0,2,101,0,0,0,0
0,0,0,2,101,0,0,0,0
0,0,0,2,101,0,0,0,0
0,0,0,2,101,0,0,0,0
0,0,0,2,101,0,0,0,0
0,0,0,2,101,0,0,0,0
0,0,0,2,101,0,0,0,0
0,0,0,2,101,0,0,0,0
0,0,0,2,101,0,0,0,0
0,0,0,2,101,0,0,0,0
0,0,0,2,101,0,0,0,0
0,0,0,2,101,0,0,0,0
0,0,0,2,101,0,0,0,0
0,0,0,2,101,0,0,0,0
0,0,0,2,101,0,0,0,0
0,0,0,2,101,0,0,0,0
0,0,0,2,101,0,0,0,0
0,0,0,2,101,0,0,0,0
0,0,0,2,101,0,0,0,0
0,0,0,2,101,0,0,0,0
0,0,0,2,101,0,0,0,0
0,0,0,2,101,0,0,0,0
0,0,0,2,101,0,0,0,0
0,0,0,2,101,0,0,0,0
0,0,0,2,101,0,0,0,0
0,0,0,2,101,0,0,0,0
0,0,0,2,101,0,0,0,0
0,0,0,2,101,0,0,0,0
0,0,0,2,101,0,0,0,0
0,0,0,2,101,0,0,0,0
0,0,0,2,101,0,0,0,0
0,0,0,2,101,0,0,0,0
0,0,0,2,101,0,0,0,0
0,0,0,2,101,0,0,0,0
0,0,0,2,101,0,0,0,0
0,0,0,2,101,0,0,0,0
0,0,0,2,101,0,0,0,0
0,0,0,2,101,0,0,0,0
0,0,0,2,101,0,0,0,0
0,0,0,2,101,0,0,0,0
0,0,0,2,101,0,0,0,0
0,0,0,2,101,0,0,0,0
0,0,0,2,101,0,0,0,0
0,0,0,2,101,0,0,0,0
0,0,0,2,101,0,0,0,0
0,0,0,2,101,0,0,0,0
0,0,0,2,101,0,0,0,0
0,0,0,2,101,0,0,0,0
0,0,0,2,101,0,0,0,0
0,0,0,2,101,0,0,0,0
0,0,0,2,101,0,0,0,0
0,0,0,2,101,0,0,0,0
0,0,0,2,101,0,0,0,0
0,0,0,2,101,0,0,0,0
0,0,0,2,101,0,0,0,0
0,0,0,2,101,0,0,0,0
0,0,0,2,101,0,0,0,0
0,0,0,2,101,0,0,0,0
0,0,0,2,101,0,0,0,0
0,0,0,2,101,0,0,0,0
0,0,0,2,101,0,0,0,0
0,0,0,2,101,0,0,0,0
0,0,0,2,101,0,0,0,0
0,0,0,2,101,0,0,0,0
0,0,0,2,101,0,0,0,0
0,0,0,2,101,0,0,0,0
0,0,0,2,101,0,0,0,0
0,0,0,2,101,0,0,0,0
0,0,0,2,101,0,0,0,0
0,0,0,2,101,0,0,0,0
0,0,0,2,101,0,0,0,0
0,0,0,2,101,0,0,0,0
0,0,0,2,101,0,0,0,0
0,0,0,2,101,0,0,0,0
0,0,0,2,101,0,0,0,0
0,0,0,2,101,0,0,0,0
0,0,0,2,101,0,0,0,0
0,0,0,2,101,0,0,0,0
0,0,0,2,101,0,0,0,0
0,0,0,2,101,0,0,0,0
0,0,0,2,101,0,0,0,0
0,0,0,2,101,0,0,0,0
0,0,0,2,101,0,0,0,0
0,0,0,2,101,0,0,0,0
0,0,0,2,101,0,0,0,0
0,0,0,2,101,0,0,0,0
0,0,0,2,101,0,0,0,0
0,0,0,2,101,0,0,0,0
0,0,0,2,101,0,0,0,0
0,0,0,2,101,0,0,0,0
0,0,0,2,101,0,0,0,0
0,0,0,2,101,0,0,0,0
0,0,0,2,101,0,0,0,0
0,0,0,2,101,0,0,0,0
0,0,0,2,101,0,0,0,0
0,0,0,2,101,0,0,0,0
0,0,0,2,101,0,0,0,0
0,0,0,2,101,0,0,0,0
0,0,0,2,101,0,0,0,0
0,0,0,2,101,0,0,0,0
0,0,0,2,101,0,0,0,0
0,0,0,2,101,0,0,0,0
0,0,0,2,101,0,0,0,0
0,0,0,2,101,0,0,0,0
0,0,0,2,101,0,0,0,0
0,0,0,2,101,0,0,0,0
0,0,0,2,101,0,0,0,0
0,0,0,2,101,0,0,0,0
0,0,0,2,101,0,0,0,0
0,0,0,2,101,0,0,0,0
0,0,0,2,101,0,0,0,0
0,0,0,2,101,0,0,0,0
0,0,0,2,101,0,0,0,0
0,0,0,2,101,0,0,0,0
0,0,0,2,101,0,0,0,0
0,0,0,2,101,0,0,0,0
0,0,0,2,101,0,0,0,0
0,0,0,2,101,0,0,0,0
0,0,0,2,101,0,0,0,0
0,0,0,2,101,0,0,0,0
0,0,0,2,101,0,0,0,0
0,0,0,2,101,0,0,0,0
0,0,0,2,101,0,0,0,0
0,0,0,2,101,0,0,0,0
0,0,0,2,101,0,0,0,0
0,0,0,2,101,0,0,0,0
0,0,0,2,101,0,0,0,0
0,0,0,2,101,0,0,0,0
0,0,0,2,101,0,0,0,0
0,0,0,2,101,0,0,0,0
0,0,0,2,101,0,0,0,0
0,0,0,2,101,0,0,0,0
0,0,0,2,101,0,0,0,0
0,0,0,2,101,0,0,0,0
0,0,0,2,101,0,0,0,0
0,0,0,2,101,0,0,0,0
0,0,0,2,101,0,0,0,0
0,0,0,2,101,0,0,0,0
0,0,0,2,101,0,0,0,0
0,0,0,2,101,0,0,0,0
0,0,0,2,101,0,0,0,0
0,0,0,2,101,0,0,0,0
0,0,0,2,101,0,0,0,0
0,0,0,2,101,0,0,0,0
0,0,0,2,101,0,0,0,0
0,0,0,2,101,0,0,0,0
0,0,0,2,101,0,0,0,0
0,0,0,2,101,0,0,0,0
0,0,0,2,101,0,0,0,0
0,0,0,2,101,0,0,0,0
0,0,0,2,101,0,0,0,0
0,0,0,2,101,0,0,0,0
0,0,0,2,101,0,0,0,0
0,0,0,2,101,0,0,0,0
0,0,0,2,101,0,0,0,0
0,0,0,2,101,0,0,0,0
0,0,0,2,101,0,0,0,0
0,0,0,2,101,0,0,0,0
0,0,0,2,101,0,0,0,0
0,0,0,2,101,0,0,0,0
0,0,0,2,101,0,0,0,0
0,0,0,2,101,0,0,0,0
0,0,0,2,101,0,0,0,0
0,0,0,2,101,0,0,0,0
0,0,0,2,101,0,0,0,0
0,0,0,2,101,0,0,0,0
0,0,0,2,101,0,0,0,0
0,0,0,2,101,0,0,0,0
0,0,0,2,101,0,0,0,0
0,0,0,2,101,0,0,0,0
0,0,0,2,101,0,0,0,0
0,0,0,2,101,0,0,0,0
0,0,0,2,101,0,0,0,0
0,0,0,2,101,0,0,0,0
0,0,0,2,101,0,0,0,0
0,0,0,2,101,0,0,0,0
0,0,0,2,101,0,0,0,0
0,0,0,2,101,0,0,0,0
0,0,0,2,101,0,0,0,0
0,0,0,2,101,0,0,0,0
0,0,0,2,101,0,0,0,0
0,0,0,2,101,0,0,0,0
0,0,0,2,101,0,0,0,0
0,0,0,2,101,0,0,0,0
0,0,0,2,101,0,0,0,0
0,0,0,2,101,0,0,0,0
0,0,0,2,101,0,0,0,0
0,0,0,2,101,0,0,0,0
0,0,0,2,101,0,0,0,0
0,0,0,2,101,0,0,0,0
0,0,0,2,101,0,0,0,0
0,0,0,2,101,0,0,0,0
0,0,0,2,101,0,0,0,0
0,0,0,2,101,0,0,0,0
0,0,0,2,101,0,0,0,0
0,0,0,2,101,0,0,0,0
0,0,0,2,101,0,0,0,0
0,0,0,2,101,0,0,0,0
0,0,0,2,101,0,0,0,0
0,0,0,2,101,0,0,0,0
0,0,0,2,101,0,0,0,0
0,0,0,2,101,0,0,0,0
0,0,0,2,101,0,0,0,0
0,0,0,2,101,0,0,0,0
0,0,0,2,101,0,0,0,0
0,0,0,2,101,0,0,0,0
0,0,0,2,101,0,0,0,0
0,0,0,2,101,0,0,0,0
0,0,0,2,101,0,0,0,0
0,0,0,2,101,0,0,0,0
0,0,0,2,101,0,0,0,0
0,0,0,2,101,0,0,0,0
0,0,0,2,101,0,0,0,0
0,0,0,2,101,0,0,0,0
0,0,0,2,101,0,0,0,0
0,0,0,2,101,0,0,0,0
0,0,0,2,101,0,0,0,0
0,0,0,2,101,0,0,0,0
0,0,0,2,101,0,0,0,0
0,0,0,2,101,0,0,0,0
0,0,0,2,101,0,0,0,0
0,0,0,2,101,0,0,0,0
0,0,0,2,101,0,0,0,0
0,0,0,2,101,0,0,0,0
0,0,0,2,101,0,0,0,0
0,0,0,2,101,0,0,0,0
0,0,0,2,101,0,0,0,0
0,0,0,2,101,0,0,0,0
0,0,0,2,101,0,0,0,0
0,0,0,2,101,0,0,0,0
0,0,0,2,101,0,0,0,0
0,0,0,2,101,0,0,0,0
0,0,0,2,101,0,0,0,0
0,0,0,2,101,0,0,0,0
0,0,0,2,101,0,0,0,0
0,0,0,2,101,0,0,0,0
0,0,0,2,101,0,0,0,0
0,0,0,2,101,0,0,0,0
0,0,0,2,101,0,0,0,0
0,0,0,2,101,0,0,0,0
0,0,0,2,101,0,0,0,0
0,0,0,2,101,0,0,0,0
0,0,0,2,101,0,0,0,0
0,0,0,2,101,0,0,0,0
0,0,0,2,101,0,0,0,0
0,0,0,2,101,0,0,0,0
0,0,0,2,101,0,0,0,0
0,0,0,2,101,0,0,0,0
0,0,0,2,101,0,0,0,0
0,0,0,2,101,0,0,0,0
0,0,0,2,101,0,0,0,0
0,0,0,2,101,0,0,0,0
0,0,0,2,101,0,0,0,0
0,0,0,2,101,0,0,0,0
0,0,0,2,101,0,0,0,0
0,0,0,2,101,0,0,0,0
0,0,0,2,101,0,0,0,0
0,0,0,2,101,0,0,0,0
0,0,0,2,101,0,0,0,0
0,0,0,2,101,0,0,0,0
0,0,0,2,101,0,0,0,0
0,0,0,2,101,0,0,0,0
0,0,0,2,101,0,0,0,0
0,0,0,2,101,0,0,0,0
0,0,0,2,101,0,0,0,0
0,0,0,2,101,0,0,0,0
0,0,0,2,101,0,0,0,0
0,0,0,2,101,0,0,0,0
0,0,0,2,101,0,0,0,0
0,0,0,2,101,0,0,0,0
0,0,0,2,101,0,0,0,0
0,0,0,2,101,0,0,0,0
0,0,0,2,101,0,0,0,0
0,0,0,2,101,0,0,0,0
0,0,0,2,101,0,0,0,0
0,0,0,2,101,0,0,0,0
0,0,0,2,101,0,0,0,0
0,0,0,2,101,0,0,0,0
0,0,0,2,101,0,0,0,0
0,0,0,2,101,0,0,0,0
0,0,0,2,101,0,0,0,0
0,0,0,2,101,0,0,0,0
0,0,0,2,101,0,0,0,0
0,0,0,2,101,0,0,0,0
0,0,0,2,101,0,0,0,0
0,0,0,2,101,0,0,0,0
0,0,0,2,101,0,0,0,0
0,0,0,2,101,0,0,0,0
0,0,0,2,101,0,0,0,0
0,0,0,2,101,0,0,0,0
0,0,0,2,101,0,0,0,0
0,0,0,2,101,0,0,0,0
0,0,0,2,101,0,0,0,0
0,0,0,2,101,0,0,0,0
0,0,0,2,101,0,0,0,0
0,0,0,2,101,0,0,0,0
0,0,0,2,101,0,0,0,0
0,0,0,2,101,0,0,0,0
0,0,0,2,101,0,0,0,0
0,0,0,2,101,0,0,0,0
0,0,0,2,101,0,0,0,0
0,0,0,2,101,0,0,0,0
0,0,0,2,101,0,0,0,0
0,0,0,2,101,0,0,0,0
0,0,0,2,101,0,0,0,0
0,0,0,2,101,0,0,0,0
0,0,0,2,101,0,0,0,0
0,0,0,2,101,0,0,0,0
0,0,0,2,101,0,0,0,0
0,0,0,2,101,0,0,0,0
0,0,0,2,101,0,0,0,0
0,0,0,2,101,0,0,0,0
0,0,0,2,101,0,0,0,0
0,0,0,2,101,0,0,0,0
0,0,0,2,101,0,0,0,0
0,0,0,2,101,0,0,0,0
0,0,0,2,101,0,0,0,0
0,0,0,2,101,0,0,0,0
0,0,0,2,101,0,0,0,0
0,0,0,2,101,0,0,0,0
0,0,0,2,101,0,0,0,0
0,0,0,2,101,0,0,0,0
0,0,0,2,101,0,0,0,0
0,0,0,2,101,0,0,0,0
0,0,0,2,101,0,0,0,0
0,0,0,2,101,0,0,0,0
0,0,0,2,101,0,0,0,0
0,0,0,2,101,0,0,0,0
0,0,0,2,101,0,0,0,0
0,0,0,2,101,0,0,0,0
0,0,0,2,101,0,0,0,0
0,0,0,2,101,0,0,0,0
0,0,0,2,101,0,0,0,0
0,0,0,2,101,0,0,0,0
0,0,0,2,101,0,0,0,0
0,0,0,2,101,0,0,0,0
0,0,0,2,101,0,0,0,0
0,0,0,2,101,0,0,0,0
0,0,0,2,101,0,0,0,0
0,0,0,2,101,0,0,0,0
0,0,0,2,101,0,0,0,0
0,0,0,2,101,0,0,0,0
0,0,0,2,101,0,0,0,0
0,0,0,2,101,0,0,0,0
0,0,0,2,101,0,0,0,0
0,0,0,2,101,0,0,0,0
0,0,0,2,101,0,0,0,0
0,0,0,2,101,0,0,0,0
0,0,0,2,101,0,0,0,0
0,0,0,2,101,0,0,0,0
0,0,0,2,101,0,0,0,0
0,0,0,2,101,0,0,0,0
0,0,0,2,101,0,0,0,0
0,0,0,2,101,0,0,0,0
0,0,0,2,101,0,0,0,0
0,0,0,2,101,0,0,0,0
0,0,0,2,101,0,0,0,0
0,0,0,2,101,0,0,0,0
0,0,0,2,101,0,0,0,0
0,0,0,2,101,0,0,0,0
0,0,0,2,101,0,0,0,0
0,0,0,2,101,0,0,0,0
0,0,0,2,101,0,0,0,0
0,0,0,2,101,0,0,0,0
0,0,0,2,101,0,0,0,0
0,0,0,2,101,0,0,0,0
0,0,0,2,101,0,0,0,0
0,0,0,2,101,0,0,0,0
0,0,0,2,101,0,0,0,0
0,0,0,2,101,0,0,0,0
0,0,0,2,101,0,0,0,0
0,0,0,2,101,0,0,0,0
0,0,0,2,101,0,0,0,0
0,0,0,2,101,0,0,0,0
0,0,0,2,101,0,0,0,0
0,0,0,2,101,0,0,0,0
0,0,0,2,101,0,0,0,0
0,0,0,2,101,0,0,0,0
0,0,0,2,101,0,0,0,0
0,0,0,2,101,0,0,0,0
0,0,0,2,101,0,0,0,0
0,0,0,2,101,0,0,0,0
0,0,0,2,101,0,0,0,0
0,0,0,2,101,0,0,0,0
0,0,0,2,101,0,0,0,0
0,0,0,2,101,0,0,0,0
0,0,0,2,101,0,0,0,0
0,0,0,2,101,0,0,0,0
0,0,0,2,101,0,0,0,0
0,0,0,2,101,0,0,0,0
0,0,0,2,101,0,0,0,0
0,0,0,2,101,0,0,0,0
0,0,0,2,101,0,0,0,0
0,0,0,2,101,0,0,0,0
0,0,0,2,101,0,0,0,0
0,0,0,2,101,0,0,0,0
0,0,0,2,101,0,0,0,0
0,0,0,2,101,0,0,0,0
0,0,0,2,101,0,0,0,0
0,0,0,2,101,0,0,0,0
0,0,0,2,101,0,0,0,0
0,0,0,2,101,0,0,0,0
0,0,0,2,101,0,0,0,0
0,0,0,2,101,0,0,0,0
0,0,0,2,101,0,0,0,0
0,0,0,2,101,0,0,0,0
0,0,0,2,101,0,0,0,0
0,0,0,2,101,0,0,0,0
0,0,0,2,101,0,0,0,0
0,0,0,2,101,0,0,0,0
0,0,0,2,101,0,0,0,0
0,0,0,2,101,0,0,0,0
0,0,0,2,101,0,0,0,0
0,0,0,2,101,0,0,0,0
0,0,0,2,101,0,0,0,0
0,0,0,2,101,0,0,0,0
0,0,0,2,101,0,0,0,0
0,0,0,2,101,0,0,0,0
0,0,0,2,101,0,0,0,0
0,0,0,2,101,0,0,0,0
0,0,0,2,101,0,0,0,0
0,0,0,2,101,0,0,0,0
0,0,0,2,101,0,0,0,0
0,0,0,2,101,0,0,0,0
0,0,0,2,101,0,0,0,0
0,0,0,2,101,0,0,0,0
0,0,0,2,101,0,0,0,0
0,0,0,2,101,0,0,0,0
0,0,0,2,101,0,0,0,0
0,0,0,2,101,0,0,0,0
0,0,0,2,101,0,0,0,0
0,0,0,2,101,0,0,0,0
0,0,0,2,101,0,0,0,0
0,0,0,2,101,0,0,0,0
0,0,0,2,101,0,0,0,0
0,0,0,2,101,0,0,0,0
0,0,0,2,101,0,0,0,0
0,0,0,2,101,0,0,0,0
0,0,0,2,101,0,0,0,0
0,0,0,2,101,0,0,0,0
0,0,0,2,101,0,0,0,0
0,0,0,2,101,0,0,0,0
0,0,0,2,101,0,0,0,0
0,0,0,2,101,0,0,0,0
0,0,0,2,101,0,0,0,0
0,0,0,2,101,0,0,0,0
0,0,0,2,101,0,0,0,0
0,0,0,2,101,0,0,0,0
0,0,0,2,101,0,0,0,0
0,0,0,2,101,0,0,0,0
0,0,0,2,101,0,0,0,0
0,0,0,2,101,0,0,0,0
0,0,0,2,101,0,0,0,0
0,0,0,2,101,0,0,0,0
0,0,0,2,101,0,0,0,0
0,0,0,2,101,0,0,0,0
0,0,0,2,101,0,0,0,0
0,0,0,2,101,0,0,0,0
0,0,0,2,101,0,0,0,0
0,0,0,2,101,0,0,0,0
0,0,0,2,101,0,0,0,0
0,0,0,2,101,0,0,0,0
0,0,0,2,101,0,0,0,0
0,0,0,2,101,0,0,0,0
0,0,0,2,101,0,0,0,0
0,0,0,2,101,0,0,0,0
0,0,0,2,101,0,0,0,0
0,0,0,2,101,0,0,0,0
0,0,0,2,101,0,0,0,0
0,0,0,2,101,0,0,0,0
0,0,0,2,101,0,0,0,0
0,0,0,2,101,0,0,0,0
0,0,0,2,101,0,0,0,0
0,0,0,2,101,0,0,0,0
0,0,0,2,101,0,0,0,0
0,0,0,2,101,0,0,0,0
0,0,0,2,101,0,0,0,0
0,0,0,2,101,0,0,0,0
0,0,0,2,101,0,0,0,0
0,0,0,2,101,0,0,0,0
0,0,0,2,101,0,0,0,0
0,0,0,2,101,0,0,0,0
0,0,0,2,101,0,0,0,0
0,0,0,2,101,0,0,0,0
0,0,0,2,101,0,0,0,0
0,0,0,2,101,0,0,0,0
0,0,0,2,101,0,0,0,0
0,0,0,2,101,0,0,0,0
0,0,0,2,101,0,0,0,0
0,0,0,2,101,0,0,0,0
0,0,0,2,101,0,0,0,0
0,0,0,2,101,0,0,0,0
0,0,0,2,101,0,0,0,0
0,0,0,2,101,0,0,0,0
0,0,0,2,101,0,0,0,0
0,0,0,2,101,0,0,0,0
0,0,0,2,101,0,0,0,0
0,0,0,2,101,0,0,0,0
0,0,0,2,101,0,0,0,0
0,0,0,2,101,0,0,0,0
0,0,0,2,101,0,0,0,0
0,0,0,2,101,0,0,0,0
0,0,0,2,101,0,0,0,0
0,0,0,2,101,0,0,0,0
0,0,0,2,101,0,0,0,0
0,0,0,2,101,0,0,0,0
0,0,0,2,101,0,0,0,0
0,0,0,2,101,0,0,0,0
0,0,0,2,101,0,0,0,0
0,0,0,2,101,0,0,0,0
0,0,0,2,101,0,0,0,0
0,0,0,2,101,0,0,0,0
0,0,0,2,101,0,0,0,0
0,0,0,2,101,0,0,0,0
0,0,0,2,101,0,0,0,0
0,0,0,2,101,0,0,0,0
0,0,0,2,101,0,0,0,0
0,0,0,2,101,0,0,0,0
0,0,0,2,101,0,0,0,0
0,0,0,2,101,0,0,0,0
0,0,0,2,101,0,0,0,0
0,0,0,2,101,0,0,0,0
0,0,0,2,101,0,0,0,0
0,0,0,2,101,0,0,0,0
0,0,0,2,101,0,0,0,0
0,0,0,2,101,0,0,0,0
0,0,0,2,101,0,0,0,0
0,0,0,2,101,0,0,0,0
0,0,0,2,101,0,0,0,0
0,0,0,2,101,0,0,0,0
0,0,0,2,101,0,0,0,0
0,0,0,2,101,0,0,0,0
0,0,0,2,101,0,0,0,0
0,0,0,2,101,0,0,0,0
0,0,0,2,101,0,0,0,0
0,0,0,2,101,0,0,0,0
0,0,0,2,101,0,0,0,0
0,0,0,2,101,0,0,0,0
0,0,0,2,101,0,0,0,0
0,0,0,2,101,0,0,0,0
0,0,0,2,101,0,0,0,0
0,0,0,2,101,0,0,0,0
0,0,0,2,101,0,0,0,0
0,0,0,2,101,0,0,0,0
0,0,0,2,101,0,0,0,0
0,0,0,2,101,0,0,0,0
0,0,0,2,101,0,0,0,0
0,0,0,2,101,0,0,0,0
0,0,0,2,101,0,0,0,0
0,0,0,2,101,0,0,0,0
0,0,0,2,101,0,0,0,0
0,0,0,2,101,0,0,0,0
0,0,0,2,101,0,0,0,0
0,0,0,2,101,0,0,0,0
0,0,0,2,101,0,0,0,0
0,0,0,2,101,0,0,0,0
0,0,0,2,101,0,0,0,0
0,0,0,2,101,0,0,0,0
0,0,0,2,101,0,0,0,0
0,0,0,2,101,0,0,0,0
0,0,0,2,101,0,0,0,0
0,0,0,2,101,0,0,0,0
0,0,0,2,101,0,0,0,0
0,0,0,2,101,0,0,0,0
0,0,0,2,101,0,0,0,0
0,0,0,2,101,0,0,0,0
0,0,0,2,101,0,0,0,0
0,0,0,2,101,0,0,0,0
0,0,0,2,101,0,0,0,0
0,0,0,2,101,0,0,0,0
0,0,0,2,101,0,0,0,0
0,0,0,2,101,0,0,0,0
0,0,0,2,101,0,0,0,0
0,0,0,2,101,0,0,0,0
0,0,0,2,101,0,0,0,0
0,0,0,2,101,0,0,0,0
0,0,0,2,101,0,0,0,0
0,0,0,2,101,0,0,0,0
0,0,0,2,101,0,0,0,0
0,0,0,2,101,0,0,0,0
0,0,0,2,101,0,0,0,0
0,0,0,2,101,0,0,0,0
0,0,0,2,101,0,0,0,0
0,0,0,2,101,0,0,0,0
0,0,0,2,101,0,0,0,0
0,0,0,2,101,0,0,0,0
0,0,0,2,101,0,0,0,0
0,0,0,2,101,0,0,0,0
0,0,0,2,101,0,0,0,0
0,0,0,2,101,0,0,0,0
0,0,0,2,101,0,0,0,0
0,0,0,2,101,0,0,0,0
0,0,0,2,101,0,0,0,0
0,0,0,2,101,0,0,0,0
0,0,0,2,101,0,0,0,0
0,0,0,2,101,0,0,0,0
0,0,0,2,101,0,0,0,0
0,0,0,2,101,0,0,0,0
0,0,0,2,101,0,0,0,0
0,0,0,2,101,0,0,0,0
0,0,0,2,101,0,0,0,0
0,0,0,2,101,0,0,0,0
0,0,0,2,101,0,0,0,0
0,0,0,2,101,0,0,0,0
0,0,0,2,101,0,0,0,0
0,0,0,2,101,0,0,0,0
0,0,0,2,101,0,0,0,0
0,0,0,2,101,0,0,0,0
0,0,0,2,101,0,0,0,0
0,0,0,2,101,0,0,0,0
0,0,0,2,101,0,0,0,0
0,0,0,2,101,0,0,0,0
0,0,0,2,101,0,0,0,0
0,0,0,2,101,0,0,0,0
0,0,0,2,101,0,0,0,0
0,0,0,2,101,0,0,0,0
0,0,0,2,101,0,0,0,0
0,0,0,2,101,0,0,0,0
0,0,0,2,101,0,0,0,0
0,0,0,2,101,0,0,0,0
0,0,0,2,101,0,0,0,0
0,0,0,2,101,0,0,0,0
0,0,0,2,101,0,0,0,0
0,0,0,2,101,0,0,0,0
0,0,0,2,101,0,0,0,0
0,0,0,2,101,0,0,0,0
0,0,0,2,101,0,0,0,0
0,0,0,2,101,0,0,0,0
0,0,0,2,101,0,0,0,0
0,0,0,2,101,0,0,0,0
0,0,0,2,101,0,0,0,0
0,0,0,2,101,0,0,0,0
0,0,0,2,101,0,0,0,0
0,0,0,2,101,0,0,0,0
0,0,0,2,101,0,0,0,0
0,0,0,2,101,0,0,0,0
0,0,0,2,101,0,0,0,0
0,0,0,2,101,0,0,0,0
0,0,0,2,101,0,0,0,0
0,0,0,2,101,0,0,0,0
0,0,0,2,101,0,0,0,0
0,0,0,2,101,0,0,0,0
0,0,0,2,101,0,0,0,0
0,0,0,2,101,0,0,0,0
0,0,0,2,101,0,0,0,0
0,0,0,2,101,0,0,0,0
0,0,0,2,101,0,0,0,0
0,0,0,2,101,0,0,0,0
0,0,0,2,101,0,0,0,0
0,0,0,2,101,0,0,0,0
0,0,0,2,101,0,0,0,0
0,0,0,2,101,0,0,0,0
0,0,0,2,101,0,0,0,0
0,0,0,2,101,0,0,0,0
0,0,0,2,101,0,0,0,0
0,0,0,2,101,0,0,0,0
0,0,0,2,101,0,0,0,0
0,0,0,2,101,0,0,0,0
0,0,0,2,101,0,0,0,0
0,0,0,2,101,0,0,0,0
0,0,0,2,101,0,0,0,0
0,0,0,2,101,0,0,0,0
0,0,0,2,101,0,0,0,0
0,0,0,2,101,0,0,0,0
0,0,0,2,101,0,0,0,0
0,0,0,2,101,0,0,0,0
0,0,0,2,101,0,0,0,0
0,0,0,2,101,0,0,0,0
0,0,0,2,101,0,0,0,0
0,0,0,2,101,0,0,0,0
0,0,0,2,101,0,0,0,0
0,0,0,2,101,0,0,0,0
0,0,0,2,101,0,0,0,0
0,0,0,2,101,0,0,0,0
0,0,0,2,101,0,0,0,0
0,0,0,2,101,0,0,0,0
0,0,0,2,101,0,0,0,0
0,0,0,2,101,0,0,0,0
0,0,0,2,101,0,0,0,0
0,0,0,2,101,0,0,0,0
0,0,0,2,101,0,0,0,0
0,0,0,2,101,0,0,0,0
0,0,0,2,101,0,0,0,0
0,0,0,2,101,0,0,0,0
0,0,0,2,101,0,0,0,0
0,0,0,2,101,0,0,0,0
0,0,0,2,101,0,0,0,0
0,0,0,2,101,0,0,0,0
0,0,0,2,101,0,0,0,0
0,0,0,2,101,0,0,0,0
0,0,0,2,101,0,0,0,0
0,0,0,2,101,0,0,0,0
0,0,0,2,101,0,0,0,0
0,0,0,2,101,0,0,0,0
0,0,0,2,101,0,0,0,0
0,0,0,2,101,0,0,0,0
0,0,0,2,101,0,0,0,0
0,0,0,2,101,0,0,0,0
0,0,0,2,101,0,0,0,0
0,0,0,2,101,0,0,0,0
0,0,0,2,101,0,0,0,0
0,0,0,2,101,0,0,0,0
0,0,0,2,101,0,0,0,0
0,0,0,2,101,0,0,0,0
0,0,0,2,101,0,0,0,0
0,0,0,2,101,0,0,0,0
0,0,0,2,101,0,0,0,0
0,0,0,2,101,0,0,0,0
0,0,0,2,101,0,0,0,0
0,0,0,2,101,0,0,0,0
0,0,0,2,101,0,0,0,0
0,0,0,2,101,0,0,0,0
0,0,0,2,101,0,0,0,0
0,0,0,2,101,0,0,0,0
0,0,0,2,101,0,0,0,0
0,0,0,2,101,0,0,0,0
0,0,0,2,101,0,0,0,0
0,0,0,2,101,0,0,0,0
0,0,0,2,101,0,0,0,0
0,0,0,2,101,0,0,0,0
0,0,0,2,101,0,0,0,0
0,0,0,2,101,0,0,0,0
0,0,0,2,101,0,0,0,0
0,0,0,2,101,0,0,0,0
0,0,0,2,101,0,0,0,0
0,0,0,2,101,0,0,0,0
0,0,0,2,101,0,0,0,0
0,0,0,2,101,0,0,0,0
0,0,0,2,101,0,0,0,0
0,0,0,2,101,0,0,0,0
0,0,0,2,101,0,0,0,0
0,0,0,2,101,0,0,0,0
0,0,0,2,101,0,0,0,0
0,0,0,2,101,0,0,0,0
0,0,0,2,101,0,0,0,0
0,0,0,2,101,0,0,0,0
0,0,0,2,101,0,0,0,0
0,0,0,2,101,0,0,0,0
0,0,0,2,101,0,0,0,0
0,0,0,2,101,0,0,0,0
0,0,0,2,101,0,0,0,0
0,0,0,2,101,0,0,0,0
0,0,0,2,101,0,0,0,0
0,0,0,2,101,0,0,0,0
0,0,0,2,101,0,0,0,0
0,0,0,2,101,0,0,0,0
0,0,0,2,101,0,0,0,0
0,0,0,2,101,0,0,0,0
0,0,0,2,101,0,0,0,0
0,0,0,2,101,0,0,0,0
0,0,0,2,101,0,0,0,0
0,0,0,2,101,0,0,0,0
0,0,0,2,101,0,0,0,0
0,0,0,2,101,0,0,0,0
0,0,0,2,101,0,0,0,0
0,0,0,2,101,0,0,0,0
0,0,0,2,101,0,0,0,0
0,0,0,2,101,0,0,0,0
0,0,0,2,101,0,0,0,0
0,0,0,2,101,0,0,0,0
0,0,0,2,101,0,0,0,0
0,0,0,2,101,0,0,0,0
0,0,0,2,101,0,0,0,0
0,0,0,2,101,0,0,0,0
0,0,0,2,101,0,0,0,0
0,0,0,2,101,0,0,0,0
0,0,0,2,101,0,0,0,0
0,0,0,2,101,0,0,0,0
0,0,0,2,101,0,0,0,0
0,0,0,2,101,0,0,0,0
0,0,0,2,101,0,0,0,0
0,0,0,2,101,0,0,0,0
0,0,0,2,101,0,0,0,0
0,0,0,2,101,0,0,0,0
0,0,0,2,101,0,0,0,0
0,0,0,2,101,0,0,0,0
0,0,0,2,101,0,0,0,0
0,0,0,2,101,0,0,0,0
0,0,0,2,101,0,0,0,0
0,0,0,2,101,0,0,0,0
0,0,0,2,101,0,0,0,0
0,0,0,2,101,0,0,0,0
0,0,0,2,101,0,0,0,0
0,0,0,2,101,0,0,0,0
0,0,0,2,101,0,0,0,0
0,0,0,2,101,0,0,0,0
0,0,0,2,101,0,0,0,0
0,0,0,2,101,0,0,0,0
0,0,0,2,101,0,0,0,0
0,0,0,2,101,0,0,0,0
0,0,0,2,101,0,0,0,0
0,0,0,2,101,0,0,0,0
0,0,0,2,101,0,0,0,0
0,0,0,2,101,0,0,0,0
0,0,0,2,101,0,0,0,0
0,0,0,2,101,0,0,0,0
0,0,0,2,101,0,0,0,0
0,0,0,2,101,0,0,0,0
0,0,0,2,101,0,0,0,0
0,0,0,2,101,0,0,0,0
0,0,0,2,101,0,0,0,0
0,0,0,2,101,0,0,0,0
0,0,0,2,101,0,0,0,0
0,0,0,2,101,0,0,0,0
0,0,0,2,101,0,0,0,0
0,0,0,2,101,0,0,0,0
0,0,0,2,101,0,0,0,0
0,0,0,2,101,0,0,0,0
0,0,0,2,101,0,0,0,0
0,0,0,2,101,0,0,0,0
0,0,0,2,101,0,0,0,0
0,0,0,2,101,0,0,0,0
0,0,0,2,101,0,0,0,0
0,0,0,2,101,0,0,0,0
0,0,0,2,101,0,0,0,0
0,0,0,2,101,0,0,0,0
0,0,0,2,101,0,0,0,0
0,0,0,2,101,0,0,0,0
0,0,0,2,101,0,0,0,0
0,0,0,2,101,0,0,0,0
0,0,0,2,101,0,0,0,0
0,0,0,2,101,0,0,0,0
0,0,0,2,101,0,0,0,0
0,0,0,2,101,0,0,0,0
0,0,0,2,101,0,0,0,0
0,0,0,2,101,0,0,0,0
0,0,0,2,101,0,0,0,0
0,0,0,2,101,0,0,0,0
0,0,0,2,101,0,0,0,0
0,0,0,2,101,0,0,0,0
0,0,0,2,101,0,0,0,0
0,0,0,2,101,0,0,0,0
0,0,0,2,101,0,0,0,0
0,0,0,2,101,0,0,0,0
0,0,0,2,101,0,0,0,0
0,0,0,2,101,0,0,0,0
0,0,0,2,101,0,0,0,0
0,0,0,2,101,0,0,0,0
0,0,0,2,101,0,0,0,0
0,0,0,2,101,0,0,0,0
0,0,0,2,101,0,0,0,0
0,0,0,2,101,0,0,0,0
0,0,0,2,101,0,0,0,0
0,0,0,2,101,0,0,0,0
0,0,0,2,101,0,0,0,0
0,0,0,2,101,0,0,0,0
0,0,0,2,101,0,0,0,0
0,0,0,2,101,0,0,0,0
0,0,0,2,101,0,0,0,0
0,0,0,2,101,0,0,0,0
0,0,0,2,101,0,0,0,0
0,0,0,2,101,0,0,0,0
0,0,0,2,101,0,0,0,0
0,0,0,2,101,0,0,0,0
0,0,0,2,101,0,0,0,0
0,0,0,2,101,0,0,0,0
0,0,0,2,101,0,0,0,0
0,0,0,2,101,0,0,0,0
0,0,0,2,101,0,0,0,0
0,0,0,2,101,0,0,0,0
0,0,0,2,101,0,0,0,0
0,0,0,2,101,0,0,0,0
0,0,0,2,101,0,0,0,0
0,0,0,2,101,0,0,0,0
0,0,0,2,101,0,0,0,0
0,0,0,2,101,0,0,0,0
0,0,0,2,101,0,0,0,0
0,0,0,2,101,0,0,0,0
0,0,0,2,101,0,0,0,0
0,0,0,2,101,0,0,0,0
0,0,0,2,101,0,0,0,0
0,0,0,2,101,0,0,0,0
0,0,0,2,101,0,0,0,0
0,0,0,2,101,0,0,0,0
0,0,0,2,101,0,0,0,0
0,0,0,2,101,0,0,0,0
0,0,0,2,101,0,0,0,0
0,0,0,2,101,0,0,0,0
0,0,0,2,101,0,0,0,0
0,0,0,2,101,0,0,0,0
0,0,0,2,101,0,0,0,0
0,0,0,2,101,0,0,0,0
0,0,0,2,101,0,0,0,0
0,0,0,2,101,0,0,0,0
0,0,0,2,101,0,0,0,0
0,0,0,2,101,0,0,0,0
0,0,0,2,101,0,0,0,0
0,0,0,2,101,0,0,0,0
0,0,0,2,101,0,0,0,0
0,0,0,2,101,0,0,0,0
0,0,0,2,101,0,0,0,0
0,0,0,2,101,0,0,0,0
0,0,0,2,101,0,0,0,0
0,0,0,2,101,0,0,0,0
0,0,0,2,101,0,0,0,0
0,0,0,2,101,0,0,0,0
0,0,0,2,101,0,0,0,0
0,0,0,2,101,0,0,0,0
0,0,0,2,101,0,0,0,0
0,0,0,2,101,0,0,0,0
0,0,0,2,101,0,0,0,0
0,0,0,2,101,0,0,0,0
0,0,0,2,101,0,0,0,0
0,0,0,2,101,0,0,0,0
0,0,0,2,101,0,0,0,0
0,0,0,2,101,0,0,0,0
0,0,0,2,101,0,0,0,0
0,0,0,2,101,0,0,0,0
0,0,0,2,101,0,0,0,0
0,0,0,2,101,0,0,0,0
0,0,0,2,101,0,0,0,0
0,0,0,2,101,0,0,0,0
0,0,0,2,101,0,0,0,0
0,0,0,2,101,0,0,0,0
0,0,0,2,101,0,0,0,0
0,0,0,2,101,0,0,0,0
0,0,0,2,101,0,0,0,0
0,0,0,2,101,0,0,0,0
0,0,0,2,101,0,0,0,0
0,0,0,2,101,0,0,0,0
0,0,0,2,101,0,0,0,0
0,0,0,2,101,0,0,0,0
0,0,0,2,101,0,0,0,0
0,0,0,2,101,0,0,0,0
0,0,0,2,101,0,0,0,0
0,0,0,2,101,0,0,0,0
0,0,0,2,101,0,0,0,0
0,0,0,2,101,0,0,0,0
0,0,0,2,101,0,0,0,0
0,0,0,2,101,0,0,0,0
0,0,0,2,101,0,0,0,0
0,0,0,2,101,0,0,0,0
0,0,0,2,101,0,0,0,0
0,0,0,2,101,0,0,0,0
0,0,0,2,101,0,0,0,0
0,0,0,2,101,0,0,0,0
0,0,0,2,101,0,0,0,0
0,0,0,2,101,0,0,0,0
0,0,0,2,101,0,0,0,0
0,0,0,2,101,0,0,0,0
0,0,0,2,101,0,0,0,0
0,0,0,2,101,0,0,0,0
0,0,0,2,101,0,0,0,0
0,0,0,2,101,0,0,0,0
0,0,0,2,101,0,0,0,0
0,0,0,2,101,0,0,0,0
0,0,0,2,101,0,0,0,0
0,0,0,2,101,0,0,0,0
0,0,0,2,101,0,0,0,0
0,0,0,2,101,0,0,0,0
0,0,0,2,101,0,0,0,0
0,0,0,2,101,0,0,0,0
0,0,0,2,101,0,0,0,0
0,0,0,2,101,0,0,0,0
0,0,0,2,101,0,0,0,0
0,0,0,2,101,0,0,0,0
0,0,0,2,101,0,0,0,0
0,0,0,2,101,0,0,0,0
0,0,0,2,101,0,0,0,0
0,0,0,2,101,0,0,0,0
0,0,0,2,101,0,0,0,0
0,0,0,2,101,0,0,0,0
0,0,0,2,101,0,0,0,0
0,0,0,2,101,0,0,0,0
0,0,0,2,101,0,0,0,0
0,0,0,2,101,0,0,0,0
0,0,0,2,101,0,0,0,0
0,0,0,2,101,0,0,0,0
0,0,0,2,101,0,0,0,0
0,0,0,2,101,0,0,0,0
0,0,0,2,101,0,0,0,0
0,0,0,2,101,0,0,0,0
0,0,0,2,101,0,0,0,0
0,0,0,2,101,0,0,0,0
0,0,0,2,101,0,0,0,0
0,0,0,2,101,0,0,0,0
0,0,0,2,101,0,0,0,0
0,0,0,2,101,0,0,0,0
0,0,0,2,101,0,0,0,0
0,0,0,2,101,0,0,0,0
0,0,0,2,101,0,0,0,0
0,0,0,2,101,0,0,0,0
0,0,0,2,101,0,0,0,0
0,0,0,2,101,0,0,0,0
0,0,0,2,101,0,0,0,0
0,0,0,2,101,0,0,0,0
0,0,0,2,101,0,0,0,0
0,0,0,2,101,0,0,0,0
0,0,0,2,101,0,0,0,0
0,0,0,2,101,0,0,0,0
0,0,0,2,101,0,0,0,0
0,0,0,2,101,0,0,0,0
0,0,0,2,101,0,0,0,0
0,0,0,2,101,0,0,0,0
0,0,0,2,101,0,0,0,0
0,0,0,2,101,0,0,0,0
0,0,0,2,101,0,0,0,0
0,0,0,2,101,0,0,0,0
0,0,0,2,101,0,0,0,0
0,0,0,2,101,0,0,0,0
0,0,0,2,101,0,0,0,0
0,0,0,2,101,0,0,0,0
0,0,0,2,101,0,0,0,0
0,0,0,2,101,0,0,0,0
0,0,0,2,101,0,0,0,0
0,0,0,2,101,0,0,0,0
0,0,0,2,101,0,0,0,0
0,0,0,2,101,0,0,0,0
0,0,0,2,101,0,0,0,0
0,0,0,2,101,0,0,0,0
0,0,0,2,101,0,0,0,0
0,0,0,2,101,0,0,0,0
0,0,0,2,101,0,0,0,0
0,0,0,2,101,0,0,0,0
0,0,0,2,101,0,0,0,0
0,0,0,2,101,0,0,0,0
0,0,0,2,101,0,0,0,0
0,0,0,2,101,0,0,0,0
0,0,0,2,101,0,0,0,0
0,0,0,2,101,0,0,0,0
0,0,0,2,101,0,0,0,0
0,0,0,2,101,0,0,0,0
0,0,0,2,101,0,0,0,0
0,0,0,2,101,0,0,0,0
0,0,0,2,101,0,0,0,0
0,0,0,2,101,0,0,0,0
0,0,0,2,101,0,0,0,0
0,0,0,2,101,0,0,0,0
0,0,0,2,101,0,0,0,0
0,0,0,2,101,0,0,0,0
0,0,0,2,101,0,0,0,0
0,0,0,2,101,0,0,0,0
0,0,0,2,101,0,0,0,0
0,0,0,2,101,0,0,0,0
0,0,0,2,101,0,0,0,0
0,0,0,2,101,0,0,0,0
0,0,0,2,101,0,0,0,0
0,0,0,2,101,0,0,0,0
0,0,0,2,101,0,0,0,0
0,0,0,2,101,0,0,0,0
0,0,0,2,101,0,0,0,0
0,0,0,2,101,0,0,0,0
0,0,0,2,101,0,0,0,0
0,0,0,2,101,0,0,0,0
0,0,0,2,101,0,0,0,0
0,0,0,2,101,0,0,0,0
0,0,0,2,101,0,0,0,0
0,0,0,2,101,0,0,0,0
0,0,0,2,101,0,0,0,0
0,0,0,2,101,0,0,0,0
0,0,0,2,101,0,0,0,0
0,0,0,2,101,0,0,0,0
0,0,0,2,101,0,0,0,0
0,0,0,2,101,0,0,0,0
0,0,0,2,101,0,0,0,0
0,0,0,2,101,0,0,0,0
0,0,0,2,101,0,0,0,0
0,0,0,2,101,0,0,0,0
0,0,0,2,101,0,0,0,0
0,0,0,2,101,0,0,0,0
0,0,0,2,101,0,0,0,0
0,0,0,2,101,0,0,0,0
0,0,0,2,101,0,0,0,0
0,0,0,2,101,0,0,0,0
0,0,0,2,101,0,0,0,0
0,0,0,2,101,0,0,0,0
0,0,0,2,101,0,0,0,0
0,0,0,2,101,0,0,0,0
0,0,0,2,101,0,0,0,0
0,0,0,2,101,0,0,0,0
0,0,0,2,101,0,0,0,0
0,0,0,2,101,0,0,0,0
0,0,0,2,101,0,0,0,0
0,0,0,2,101,0,0,0,0
0,0,0,2,101,0,0,0,0
0,0,0,2,101,0,0,0,0
0,0,0,2,101,0,0,0,0
0,0,0,2,101,0,0,0,0
0,0,0,2,101,0,0,0,0
0,0,0,2,101,0,0,0,0
0,0,0,2,101,0,0,0,0
0,0,0,2,101,0,0,0,0
0,0,0,2,101,0,0,0,0
0,0,0,2,101,0,0,0,0
0,0,0,2,101,0,0,0,0
0,0,0,2,101,0,0,0,0
0,0,0,2,101,0,0,0,0
0,0,0,2,101,0,0,0,0
0,0,0,2,101,0,0,0,0
0,0,0,2,101,0,0,0,0
0,0,0,2,101,0,0,0,0
0,0,0,2,101,0,0,0,0
0,0,0,2,101,0,0,0,0
0,0,0,2,101,0,0,0,0
0,0,0,2,101,0,0,0,0
0,0,0,2,101,0,0,0,0
0,0,0,2,101,0,0,0,0
0,0,0,2,101,0,0,0,0
0,0,0,2,101,0,0,0,0
0,0,0,2,101,0,0,0,0
0,0,0,2,101,0,0,0,0
0,0,0,2,101,0,0,0,0
0,0,0,2,101,0,0,0,0
0,0,0,2,101,0,0,0,0
0,0,0,2,101,0,0,0,0
0,0,0,2,101,0,0,0,0
0,0,0,2,101,0,0,0,0
0,0,0,2,101,0,0,0,0
0,0,0,2,101,0,0,0,0
0,0,0,2,101,0,0,0,0
0,0,0,2,101,0,0,0,0
0,0,0,2,101,0,0,0,0
0,0,0,2,101,0,0,0,0
0,0,0,2,101,0,0,0,0
0,0,0,2,101,0,0,0,0
0,0,0,2,101,0,0,0,0
0,0,0,2,101,0,0,0,0
0,0,0,2,101,0,0,0,0
0,0,0,2,101,0,0,0,0
0,0,0,2,101,0,0,0,0
0,0,0,2,101,0,0,0,0
0,0,0,2,101,0,0,0,0
0,0,0,2,101,0,0,0,0
0,0,0,2,101,0,0,0,0
0,0,0,2,101,0,0,0,0
0,0,0,2,101,0,0,0,0
0,0,0,2,101,0,0,0,0
0,0,0,2,101,0,0,0,0
0,0,0,2,101,0,0,0,0
0,0,0,2,101,0,0,0,0
0,0,0,2,101,0,0,0,0
0,0,0,2,101,0,0,0,0
0,0,0,2,101,0,0,0,0
0,0,0,2,101,0,0,0,0
0,0,0,2,101,0,0,0,0
0,0,0,2,101,0,0,0,0
0,0,0,2,101,0,0,0,0
0,0,0,2,101,0,0,0,0
0,0,0,2,101,0,0,0,0
0,0,0,2,101,0,0,0,0
0,0,0,2,101,0,0,0,0
0,0,0,2,101,0,0,0,0
0,0,0,2,101,0,0,0,0
0,0,0,2,101,0,0,0,0
0,0,0,2,101,0,0,0,0
0,0,0,2,101,0,0,0,0
0,0,0,2,101,0,0,0,0
0,0,0,2,101,0,0,0,0
0,0,0,2,101,0,0,0,0
0,0,0,2,101,0,0,0,0
0,0,0,2,101,0,0,0,0
0,0,0,2,101,0,0,0,0
0,0,0,2,101,0,0,0,0
0,0,0,2,101,0,0,0,0
0,0,0,2,101,0,0,0,0
0,0,0,2,101,0,0,0,0
0,0,0,2,101,0,0,0,0
0,0,0,2,101,0,0,0,0
0,0,0,2,101,0,0,0,0
0,0,0,2,101,0,0,0,0
0,0,0,2,101,0,0,0,0
0,0,0,2,101,0,0,0,0
0,0,0,2,101,0,0,0,0
0,0,0,2,101,0,0,0,0
0,0,0,2,101,0,0,0,0
0,0,0,2,101,0,0,0,0
0,0,0,2,101,0,0,0,0
0,0,0,2,101,0,0,0,0
0,0,0,2,101,0,0,0,0
0,0,0,2,101,0,0,0,0
0,0,0,2,101,0,0,0,0
0,0,0,2,101,0,0,0,0
0,0,0,2,101,0,0,0,0
0,0,0,2,101,0,0,0,0
0,0,0,2,101,0,0,0,0
0,0,0,2,101,0,0,0,0
0,0,0,2,101,0,0,0,0
0,0,0,2,101,0,0,0,0
0,0,0,2,101,0,0,0,0
0,0,0,2,101,0,0,0,0
0,0,0,2,101,0,0,0,0
0,0,0,2,101,0,0,0,0
0,0,0,2,101,0,0,0,0
0,0,0,2,101,0,0,0,0
0,0,0,2,101,0,0,0,0
0,0,0,2,101,0,0,0,0
0,0,0,2,101,0,0,0,0
0,0,0,2,101,0,0,0,0
0,0,0,2,101,0,0,0,0
0,0,0,2,101,0,0,0,0
0,0,0,2,101,0,0,0,0
0,0,0,2,101,0,0,0,0
0,0,0,2,101,0,0,0,0
0,0,0,2,101,0,0,0,0
0,0,0,2,101,0,0,0,0
0,0,0,2,101,0,0,0,0
0,0,0,2,101,0,0,0,0
0,0,0,2,101,0,0,0,0
0,0,0,2,101,0,0,0,0
0,0,0,2,101,0,0,0,0
0,0,0,2,101,0,0,0,0
0,0,0,2,101,0,0,0,0
0,0,0,2,101,0,0,0,0
0,0,0,2,101,0,0,0,0
0,0,0,2,101,0,0,0,0
0,0,0,2,101,0,0,0,0
0,0,0,2,101,0,0,0,0
0,0,0,2,101,0,0,0,0
0,0,0,2,101,0,0,0,0
0,0,0,2,101,0,0,0,0
0,0,0,2,101,0,0,0,0
0,0,0,2,101,0,0,0,0
0,0,0,2,101,0,0,0,0
0,0,0,2,101,0,0,0,0
0,0,0,2,101,0,0,0,0
0,0,0,2,101,0,0,0,0
0,0,0,2,101,0,0,0,0
0,0,0,2,101,0,0,0,0
0,0,0,2,101,0,0,0,0
0,0,0,2,101,0,0,0,0
0,0,0,2,101,0,0,0,0
0,0,0,2,101,0,0,0,0
0,0,0,2,101,0,0,0,0
0,0,0,2,101,0,0,0,0
0,0,0,2,101,0,0,0,0
0,0,0,2,101,0,0,0,0
0,0,0,2,101,0,0,0,0
0,0,0,2,101,0,0,0,0
0,0,0,2,101,0,0,0,0
0,0,0,2,101,0,0,0,0
0,0,0,2,101,0,0,0,0
0,0,0,2,101,0,0,0,0
0,0,0,2,101,0,0,0,0
0,0,0,2,101,0,0,0,0
0,0,0,2,101,0,0,0,0
0,0,0,2,101,0,0,0,0
0,0,0,2,101,0,0,0,0
0,0,0,2,101,0,0,0,0
0,0,0,2,101,0,0,0,0
0,0,0,2,101,0,0,0,0
0,0,0,2,101,0,0,0,0
0,0,0,2,101,0,0,0,0
0,0,0,2,101,0,0,0,0
0,0,0,2,101,0,0,0,0
0,0,0,2,101,0,0,0,0
0,0,0,2,101,0,0,0,0
0,0,0,2,101,0,0,0,0
0,0,0,2,101,0,0,0,0
0,0,0,2,101,0,0,0,0
0,0,0,2,101,0,0,0,0
0,0,0,2,101,0,0,0,0
0,0,0,2,101,0,0,0,0
0,0,0,2,101,0,0,0,0
0,0,0,2,101,0,0,0,0
0,0,0,2,101,0,0,0,0
0,0,0,2,101,0,0,0,0
0,0,0,2,101,0,0,0,0
0,0,0,2,101,0,0,0,0
0,0,0,2,101,0,0,0,0
0,0,0,2,101,0,0,0,0
0,0,0,2,101,0,0,0,0
0,0,0,2,101,0,0,0,0
0,0,0,2,101,0,0,0,0
0,0,0,2,101,0,0,0,0
0,0,0,2,101,0,0,0,0
0,0,0,2,101,0,0,0,0
0,0,0,2,101,0,0,0,0
0,0,0,2,101,0,0,0,0
0,0,0,2,101,0,0,0,0
0,0,0,2,101,0,0,0,0
0,0,0,2,101,0,0,0,0
0,0,0,2,101,0,0,0,0
0,0,0,2,101,0,0,0,0
0,0,0,2,101,0,0,0,0
0,0,0,2,101,0,0,0,0
0,0,0,2,101,0,0,0,0
0,0,0,2,101,0,0,0,0
0,0,0,2,101,0,0,0,0
0,0,0,2,101,0,0,0,0
0,0,0,2,101,0,0,0,0
0,0,0,2,101,0,0,0,0
0,0,0,2,101,0,0,0,0
0,0,0,2,101,0,0,0,0
0,0,0,2,101,0,0,0,0
0,0,0,2,101,0,0,0,0
0,0,0,2,101,0,0,0,0
0,0,0,2,101,0,0,0,0
0,0,0,2,101,0,0,0,0
0,0,0,2,101,0,0,0,0
0,0,0,2,101,0,0,0,0
0,0,0,2,101,0,0,0,0
0,0,0,2,101,0,0,0,0
0,0,0,2,101,0,0,0,0
0,0,0,2,101,0,0,0,0
0,0,0,2,101,0,0,0,0
0,0,0,2,101,0,0,0,0
0,0,0,2,101,0,0,0,0
0,0,0,2,101,0,0,0,0
0,0,0,2,101,0,0,0,0
0,0,0,2,101,0,0,0,0
0,0,0,2,101,0,0,0,0
0,0,0,2,101,0,0,0,0
0,0,0,2,101,0,0,0,0
0,0,0,2,101,0,0,0,0
0,0,0,2,101,0,0,0,0
0,0,0,2,101,0,0,0,0
0,0,0,2,101,0,0,0,0
0,0,0,2,101,0,0,0,0
0,0,0,2,101,0,0,0,0
0,0,0,2,101,0,0,0,0
0,0,0,2,101,0,0,0,0
0,0,0,2,101,0,0,0,0
0,0,0,2,101,0,0,0,0
0,0,0,2,101,0,0,0,0
0,0,0,2,101,0,0,0,0
0,0,0,2,101,0,0,0,0
0,0,0,2,101,0,0,0,0
0,0,0,2,101,0,0,0,0
0,0,0,2,101,0,0,0,0
0,0,0,2,101,0,0,0,0
0,0,0,2,101,0,0,0,0
0,0,0,2,101,0,0,0,0
0,0,0,2,101,0,0,0,0
0,0,0,2,101,0,0,0,0
0,0,0,2,101,0,0,0,0
0,0,0,2,101,0,0,0,0
0,0,0,2,101,0,0,0,0
0,0,0,2,101,0,0,0,0
0,0,0,2,101,0,0,0,0
0,0,0,2,101,0,0,0,0
0,0,0,2,101,0,0,0,0
0,0,0,2,101,0,0,0,0
0,0,0,2,101,0,0,0,0
0,0,0,2,101,0,0,0,0
0,0,0,2,101,0,0,0,0
0,0,0,2,101,0,0,0,0
0,0,0,2,101,0,0,0,0
0,0,0,2,101,0,0,0,0
0,0,0,2,101,0,0,0,0
0,0,0,2,101,0,0,0,0
0,0,0,2,101,0,0,0,0
0,0,0,2,101,0,0,0,0
0,0,0,2,101,0,0,0,0
0,0,0,2,101,0,0,0,0
0,0,0,2,101,0,0,0,0
0,0,0,2,101,0,0,0,0
0,0,0,2,101,0,0,0,0
0,0,0,2,101,0,0,0,0
0,0,0,2,101,0,0,0,0
0,0,0,2,101,0,0,0,0
