CODECHURN,LOCADDED,LOCDELETED,REVISIONS,AGE,BUGFIXES,REFACTORINGS,ERROR_DENSITY,LOC
4,2,2,1,174,0,0,0.00454545454545455,220
4,2,2,1,174,0,0,0,328
4,2,2,1,174,0,0,0,239
4,2,2,1,174,0,0,0,398
4,2,2,1,174,0,0,0,939
4,2,2,1,174,0,0,0,986
8,4,4,2,167,1,0,0.001230012300123,813
4,2,2,1,174,0,0,0,266
4,2,2,1,174,0,0,0,73
4,2,2,1,174,0,0,0,39
4,2,2,1,174,0,0,0,46
572,340,232,9,33,3,0,0.000555555555555556,3600
8,4,4,2,171,0,0,0,86
4,2,2,1,174,0,0,0,76
4,2,2,1,174,0,0,0,204
4,2,2,1,174,0,0,0,122
9,5,4,2,33,1,0,0,221
25,15,10,3,158,0,0,0,352
4,2,2,1,174,0,0,0,34
13,7,6,1,171,0,0,0,367
7,4,3,2,145,0,0,0,49
4,2,2,1,174,0,0,0,48
4,2,2,1,174,0,0,0,359
72,59,13,3,158,0,0,0,351
7,4,3,2,158,0,0,0,35
4,2,2,1,174,0,0,0,29
4,2,2,1,174,0,0,0,554
19,12,7,3,158,0,0,0,360
4,2,2,1,174,0,0,0,41
4,2,2,1,174,0,0,0,59
4,2,2,1,174,0,0,0,63
4,2,2,1,174,0,0,0,837
136,100,36,4,165,0,0,0,515
9,4,5,2,159,0,0,0,1878
8,4,4,2,102,1,0,0,692
4,2,2,1,174,0,0,0,35
4,2,2,1,174,0,0,0,645
4,2,2,1,174,0,0,0,242
252,140,112,10,27,3,0,0.000287397614599799,6959
4,2,2,1,159,0,0,0,1245
4,2,2,1,174,0,0,0,91
24,15,9,2,25,1,0,0.00230414746543779,434
4,2,2,1,174,0,0,0,51
18,6,12,2,165,0,0,0,1149
4,2,2,1,174,0,0,0,851
4,2,2,1,174,0,0,0,150
4,2,2,1,174,0,0,0,102
169,121,48,12,4,1,0,0.000410424789657295,4873
4,2,2,1,174,0,0,0,518
4,2,2,1,174,0,0,0,495
4,2,2,1,174,0,0,0,1317
194,170,24,6,104,1,0,0.000551267916207277,5442
32,26,6,3,24,0,0,0.000382555470543229,2614
4,2,2,1,174,0,0,0,282
18,10,8,5,18,0,0,0.0056980056980057,351
83,48,35,13,3,1,0,0.000802568218298555,1246
25,15,10,7,18,1,0,0.00131752305665349,759
4,2,2,1,174,0,0,0,456
386,75,311,5,118,1,0,0,3118
23,9,14,3,118,1,0,0,364
4,2,2,1,174,0,0,0,66
7,4,3,2,167,0,0,0,189
27,18,9,3,24,0,0,0,1070
4,2,2,1,174,0,0,0,146
4,2,2,1,174,0,0,0,21
4,2,2,1,174,0,0,0,397
4,2,2,1,174,0,0,0,16
4,2,2,1,174,0,0,0,123
4,2,2,1,174,0,0,0,18
4,2,2,1,174,0,0,0,558
4,2,2,1,174,0,0,0,18
61,50,11,3,14,1,0,0.000682128240109141,1466
4,2,2,1,174,0,0,0,24
4,2,2,1,174,0,0,0,115
4,2,2,1,174,0,0,0,16
4,2,2,1,174,0,0,0,67
4,2,2,1,174,0,0,0,410
4,2,2,1,174,0,0,0,25
4,2,2,1,174,0,0,0,436
4,2,2,1,174,0,0,0,18
4,2,2,1,174,0,0,0,104
4,2,2,1,174,0,0,0,18
4,2,2,1,174,0,0,0,279
4,2,2,1,174,0,0,0,17
4,2,2,1,174,0,0,0,619
4,2,2,1,174,0,0,0,18
4,2,2,1,174,0,0,0,56
4,2,2,1,174,0,0,0,16
61,55,6,4,17,0,0,0,525
4,2,2,1,174,0,0,0,18
4,2,2,1,174,0,0,0,164
4,2,2,1,174,0,0,0,18
4,2,2,1,174,0,0,0,69
4,2,2,1,174,0,0,0,16
4,2,2,1,174,0,0,0,82
4,2,2,1,174,0,0,0,16
4,2,2,1,174,0,0,0,144
32,19,13,5,33,1,0,0.00123152709359606,812
20,12,8,2,25,1,0,0,1526
31,19,12,4,4,0,0,0,1274
8,4,4,1,159,0,0,0.00136612021857923,732
108,60,48,2,133,1,0,0,713
4,2,2,1,174,0,0,0,102
4,2,2,1,174,0,0,0,811
4,2,2,1,174,0,0,0,23
114,97,17,4,145,0,0,0,1881
4,3,1,1,17,0,0,0,192
9,5,4,2,167,0,0,0,1370
4,2,2,1,174,0,0,0,972
56,42,14,7,33,2,0,0.000517732332384157,3863
85,27,58,4,18,0,0,0.000282645562464669,3538
140,103,37,7,28,2,0,0,959
4,2,2,1,174,0,0,0,830
4,2,2,1,174,0,0,0,351
33,25,8,3,14,1,0,0,1954
4,2,2,1,174,0,0,0,130
4,2,2,1,174,0,0,0,33
4,2,2,1,174,0,0,0,426
4,2,2,1,174,0,0,0,41
4,2,2,1,174,0,0,0,202
4,2,2,1,174,0,0,0,36
7,4,3,2,118,1,0,0,398
4,2,2,1,174,0,0,0,43
4,2,2,1,174,0,0,0,426
4,2,2,1,174,0,0,0,39
29,24,5,2,174,0,0,0,535
4,2,2,1,174,0,0,0,42
42,30,12,3,18,0,0,0.0010989010989011,910
7,4,3,2,18,0,0,0,78
4,2,2,1,174,0,0,0,86
4,2,2,1,174,0,0,0,50
4,2,2,1,174,0,0,0,33
4,2,2,1,174,0,0,0,133
4,2,2,1,174,0,0,0,119
4,2,2,1,174,0,0,0,92
4,2,2,1,174,0,0,0,82
4,2,2,1,174,0,0,0,212
4,2,2,1,174,0,0,0,108
4,2,2,1,174,0,0,0,143
4,2,2,1,174,0,0,0,46
4,2,2,1,174,0,0,0,817
398,342,56,4,97,2,0,0,3142
255,183,72,13,4,2,0,0.00106496272630458,3756
4,2,2,1,174,0,0,0,535
23,19,4,1,28,1,0,0,411
4,2,2,1,174,0,0,0.00396825396825397,756
4,2,2,1,159,0,0,0.00869565217391304,230
4,2,2,1,174,0,0,0.00203665987780041,491
4,2,2,1,174,0,0,0,554
4,2,2,1,174,0,0,0,55
34,25,9,3,158,0,0,0,1555
8,5,3,2,160,0,0,0.00252525252525253,792
15,11,4,2,167,1,0,0.0024330900243309,1233
16,10,6,2,167,1,0,0.000971817298347911,1029
4,2,2,1,174,0,0,0,152
4,2,2,1,174,0,0,0,191
4,2,2,1,174,0,0,0.00100050025012506,1999
140,97,43,8,95,1,0,0,3221
7,4,3,2,95,0,0,0,98
61,55,6,2,153,0,0,0,870
4,2,2,1,174,0,0,0,47
36,28,8,2,144,0,0,0,783
4,2,2,1,174,0,0,0,34
82,75,7,3,137,0,0,0,1096
7,4,3,2,160,0,0,0,50
204,139,65,6,144,1,0,0.000339328130302002,2947
7,4,3,2,153,0,0,0,80
65,58,7,2,95,0,0,0,600
9,5,4,2,95,0,0,0,22
4,2,2,1,174,0,0,0.00289855072463768,345
69,54,15,7,31,1,0,0.00104566050888811,2869
20,10,10,5,34,1,0,0,59
6,3,3,1,110,1,0,0,137
0,0,0,1,174,0,0,0,27
0,0,0,1,175,0,0,0,715
0,0,0,1,175,0,0,0,41
0,0,0,1,175,0,0,0,898
72,33,39,2,165,0,0,0,582
0,0,0,1,175,0,0,0,104
0,0,0,1,175,0,0,0,11
0,0,0,1,175,0,0,0,42
0,0,0,1,175,0,0,0,169
0,0,0,1,175,0,0,0,612
0,0,0,1,175,0,0,0,26
