CODECHURN,LOCADDED,LOCDELETED,REVISIONS,AGE,BUGFIXES,REFACTORINGS,ERROR_DENSITY,LOC
9,4,5,2,9,0,0,0.0014336917562724,1395
7,4,3,1,54,1,0,0.00884955752212389,113
155,84,71,7,38,1,0,0.00346620450606586,577
7,4,3,3,38,0,0,0.010989010989011,91
12,6,6,2,49,1,0,0.0045662100456621,219
4,2,2,1,49,1,0,0.0149253731343284,67
4,2,2,1,51,0,0,0.0103092783505155,97
8,4,4,1,51,0,0,0.0144927536231884,69
346,173,173,13,9,3,0,0.00430663221360896,2322
49,26,23,4,51,0,0,0.0182926829268293,164
4,2,2,1,51,0,0,0.00625,160
8,4,4,1,51,0,0,0.0114942528735632,87
12,8,4,1,33,0,0,0.0120481927710843,83
0,0,0,1,54,0,0,0,0
19,3,16,1,54,0,0,0.00357568533969011,839
1,0,1,1,54,0,0,0.00980392156862745,102
17,11,6,5,33,2,0,0.00485436893203883,206
3,2,1,1,51,0,0,0.0181818181818182,55
99,69,30,4,21,1,1,0.0220588235294118,136
2,1,1,2,21,1,1,0.0555555555555556,36
5548,3106,2442,20,7,10,1,0.00398759415152858,2257
662,414,248,6,11,4,1,0.0161943319838057,247
2,1,1,1,79,0,0,0,31
1732,1065,667,9,7,3,0,0.00364077669902913,824
1203,729,474,8,7,3,0,0.00433839479392625,461
1844,906,938,2,30,0,0,0.000777000777000777,1287
288,144,144,2,30,0,0,0.00564971751412429,177
16485,9664,6821,24,5,12,0,0.00110533878633801,9047
7269,4199,3070,12,7,6,0,0.00136537411250683,3662
186,138,48,5,29,3,0,0.00552486187845304,181
217,137,80,5,29,3,0,0.00699300699300699,143
175,96,79,4,7,1,0,0.00645161290322581,155
55,28,27,4,7,1,0,0.0161290322580645,62
37,18,19,2,30,0,0,0,41
645,323,322,1,30,0,0,0,674
259,154,105,2,30,0,0,0,444
13,11,2,1,21,0,0,0.0137339055793991,1165
30,21,9,1,21,0,0,0.0174418604651163,172
50,27,23,1,21,0,0,0.021505376344086,93
5855,1055,4800,14,16,2,3,0.00794392523364486,2140
2404,299,2105,10,16,1,3,0.00300075018754689,1333
0,0,0,1,19,0,1,0.00640439158279963,1093
0,0,0,1,19,0,1,0.0134228187919463,149
290,280,10,3,16,1,2,0.0126582278481013,632
17,11,6,2,19,1,2,0.0396039603960396,101
2,1,1,2,16,0,0,0.00519031141868512,578
42,27,15,1,19,1,1,0.0091324200913242,438
66,38,28,1,19,1,1,0.0184331797235023,217
0,0,0,1,19,0,1,0.037037037037037,27
0,0,0,1,19,0,1,0.0277777777777778,36
180,179,1,4,16,0,0,0.00909090909090909,220
108,108,0,3,16,0,0,0.00943396226415094,212
16,2,14,1,19,1,1,0.0210526315789474,95
36,13,23,1,19,1,1,0.0229885057471264,87
15,4,11,2,16,1,1,0.00851063829787234,940
0,0,0,1,19,1,1,0.0194174757281553,103
40,20,20,1,24,0,0,0.000623830318153462,1603
8,4,4,1,24,0,0,0.000438020148926851,2283
4,2,2,1,85,1,0,0.0120481927710843,83
27,14,13,1,24,0,0,0.000355239786856128,2815
2,1,1,1,84,0,0,0.000790513833992095,1265
4,2,2,2,37,2,0,0.000536480686695279,1864
1,0,1,1,78,0,0,0.00900900900900901,111
1,0,1,1,78,0,0,0.00892857142857143,112
2,0,2,1,78,0,0,0.00183150183150183,546
3,2,1,1,63,0,0,0.000968054211035818,1033
2,1,1,1,85,1,0,0.00107181136120043,933
2,1,1,1,84,1,0,0.00478468899521531,209
2,1,1,1,84,1,0,0.00179856115107914,556
15,8,7,1,62,1,0,0.00352112676056338,568
144,106,38,4,26,4,0,0.0024906600249066,803
26,17,9,2,62,2,0,0.00606060606060606,165
37,35,2,2,51,0,0,0.00446428571428571,224
4,4,0,1,51,0,0,0.0222222222222222,45
149,92,57,11,26,4,0,0.0015552099533437,643
33,22,11,2,62,2,0,0.0116279069767442,86
194,132,62,5,51,3,0,0.00402414486921529,497
19,17,2,3,51,3,0,0.00769230769230769,130
606,344,262,7,41,4,0,0.00277264325323475,1082
18,16,2,3,41,2,0,0.00510204081632653,196
6,3,3,3,60,3,0,0,0
4,2,2,1,84,0,0,0.00045024763619991,2221
4,2,2,2,84,1,0,0.000398089171974522,2512
2,1,1,1,85,1,0,0.000580383052814858,1723
33,17,16,4,35,2,0,0.000381533765738268,2621
7,4,3,1,35,1,0,0.00446428571428571,224
1,0,1,1,78,0,0,0.0163934426229508,61
8,0,8,1,9,0,0,0,34
33,28,5,2,44,1,0,0.00249376558603491,401
0,0,0,2,5,0,0,0.00649350649350649,154
6,3,3,3,3,1,0,0.0222222222222222,45
4,4,0,1,64,1,0,0,147
0,0,0,1,9,0,0,0,0
0,0,0,1,9,0,0,0,0
6,4,2,2,9,1,0,0,0
0,0,0,1,9,0,0,0,0
0,0,0,1,9,0,0,0,0
0,0,0,1,9,0,0,0,0
0,0,0,1,8,0,0,0,0
1,1,0,2,14,1,0,0,186
0,0,0,1,21,0,0,0,61
0,0,0,1,21,0,0,0,92
0,0,0,1,21,0,0,0,45
0,0,0,1,21,0,0,0,39
0,0,0,1,21,0,0,0,35
8,4,4,2,51,1,0,0.00574712643678161,348
2,1,1,1,51,0,0,0,48
54,27,27,3,22,1,0,0,261
3,2,1,2,22,0,0,0,80
69,49,20,2,22,1,0,0,188
10,6,4,2,22,1,0,0,54
0,0,0,1,24,0,0,0,39
0,0,0,1,24,0,0,0,35
0,0,0,1,18,0,0,0,316
0,0,0,1,18,0,0,0,128
32,16,16,3,16,1,0,0,293
0,0,0,1,18,0,0,0,67
0,0,0,1,18,0,0,0,39
0,0,0,1,18,0,0,0,35
0,0,0,1,21,0,0,0,223
0,0,0,1,21,0,0,0,69
0,0,0,1,21,0,0,0,107
0,0,0,1,21,0,0,0,51
0,0,0,1,21,0,0,0,39
0,0,0,1,21,0,0,0,35
6,4,2,2,16,1,0,0,107
0,0,0,1,23,0,0,0,48
0,0,0,1,23,0,0,0,66
0,0,0,1,23,0,0,0,46
0,0,0,1,23,0,0,0,39
0,0,0,1,23,0,0,0,35
10,10,0,5,18,0,0,0,51
8,4,4,1,51,0,0,0,98
2,1,1,1,51,0,0,0,44
4,2,2,1,51,0,0,0.0111111111111111,90
2,1,1,1,51,0,0,0,48
3,2,1,1,0,1,0,0,432
17,9,8,1,9,0,0,0,633
3,2,1,1,9,0,0,0,144
12,4,8,2,16,2,0,0.00196850393700787,508
5,2,3,2,16,2,0,0,112
8,4,4,2,5,0,0,0.00164744645799012,607
24,12,12,2,5,0,0,0.00151975683890578,658
6,3,3,2,8,0,0,0,4
9,6,3,1,51,0,0,0,164
2,1,1,1,51,0,0,0,52
12,5,7,1,9,0,0,0,353
8,6,2,1,24,0,0,0,320
19,11,8,3,8,1,0,0.00186567164179104,536
7,4,3,1,16,0,0,0,130
307,157,150,10,6,4,0,0.00148588410104012,1346
12,3,9,3,36,2,0,0,178
97,2,95,1,16,0,0,0.00434782608695652,230
31,2,29,1,16,0,0,0.0108695652173913,92
12,6,6,2,49,1,0,0,510
4,2,2,1,36,1,0,0.00181488203266788,551
4,3,1,1,24,0,0,0.00239808153477218,417
1,0,1,1,9,0,0,0,440
8,4,4,2,5,0,0,0,338
12,6,6,2,5,0,0,0.00347222222222222,288
0,0,0,1,9,0,0,0,0
0,0,0,1,9,0,0,0,0
0,0,0,1,9,0,0,0,0
0,0,0,1,9,0,0,0,0
8,4,4,1,24,0,0,0,81
7,4,3,1,49,0,0,0.00467289719626168,214
1,1,0,1,49,0,0,0,84
35,20,15,3,68,2,0,0,65
18,10,8,3,22,1,0,0,175
4,2,2,1,63,0,0,0,72
6,3,3,1,63,0,0,0,38
2,1,1,1,63,0,0,0,74
4,2,2,1,63,0,0,0,42
19,9,10,1,68,0,0,0,176
2,1,1,1,63,0,0,0,59
4,2,2,1,63,0,0,0,41
2,1,1,1,63,0,0,0,37
4,2,2,1,63,0,0,0,36
0,0,0,1,63,0,0,0,49
0,0,0,1,63,0,0,0,50
0,0,0,1,63,0,0,0,0
0,0,0,1,63,0,0,0,0
8,4,4,1,63,0,0,0,268
8,4,4,1,63,0,0,0,78
4,2,2,1,24,0,0,0,226
9,5,4,2,33,2,0,0,322
1,0,1,1,33,0,0,0,211
2,2,0,1,80,1,0,0,255
8,5,3,3,20,0,0,0.00298889837745517,2342
25,19,6,2,28,1,0,0.00328407224958949,609
49,35,14,4,20,1,0,0.00334821428571429,1792
18,15,3,2,20,1,0,0.00246305418719212,406
23,15,8,2,28,1,0,0.00178571428571429,560
2,2,0,1,34,1,0,0.00520833333333333,192
2,1,1,1,28,0,0,0.00246305418719212,406
4,2,2,2,75,2,0,0.00540540540540541,185
0,0,0,1,50,0,0,0,0
0,0,0,1,50,0,0,0,0
2,1,1,1,84,1,0,0.00303951367781155,329
4,2,2,1,24,0,0,0.00263157894736842,380
2,1,1,1,84,1,0,0.0031104199066874,1286
2,1,1,1,84,1,0,0.00176056338028169,568
150,55,95,4,24,3,0,0.00183528332186281,4359
18,9,9,1,24,0,0,0.000697836706210747,1433
2,1,1,1,33,1,0,0.00881057268722467,454
13,8,5,2,20,0,0,0.0033003300330033,606
2,1,1,1,20,0,0,0.0128205128205128,156
50,25,25,1,21,0,0,0.00135256988277728,2218
15,11,4,2,71,2,0,0.000352485019386676,2837
4,3,1,1,71,1,0,0.00151975683890578,658
12,6,6,1,11,0,0,0.00143061516452074,699
5,2,3,1,11,0,0,0.0119047619047619,84
116,55,61,3,11,1,0,0.000903342366757001,1107
18,9,9,2,11,1,0,0.0072992700729927,137
2,0,2,1,50,0,0,0.0062111801242236,161
27,13,14,1,11,0,0,0.0111111111111111,180
138,69,69,2,11,1,0,0.000534902380315592,3739
4,2,2,1,11,0,0,0.00158478605388273,631
15,7,8,1,11,0,0,0.0125,80
21,10,11,1,11,0,0,0.00595238095238095,168
8,4,4,1,11,0,0,0.0175438596491228,57
19,9,10,1,11,0,0,0.00840336134453781,119
8,4,4,1,11,0,0,0.0181818181818182,55
26,10,16,1,11,0,0,0.00161030595813205,621
26,12,14,2,11,1,0,0.00294117647058824,340
33,23,10,1,33,1,0,0.000452898550724638,2208
64,15,49,2,33,2,0,0.00259067357512953,386
4,2,2,1,21,0,0,0.00284495021337127,1406
37,37,0,1,20,0,0,0.00203252032520325,492
22,9,13,2,51,1,0,0.000323206205559147,3094
16,8,8,1,24,0,0,0.00196078431372549,510
27,26,1,2,6,1,0,0.00186046511627907,1075
11,10,1,2,6,1,0,0.00357142857142857,280
8,4,4,1,24,0,0,0.000986193293885602,1014
41,31,10,2,24,0,0,0.000623441396508728,1604
5,3,2,1,24,0,0,0.0034965034965035,286
26,13,13,2,15,0,0,0.00109769484083425,911
0,0,0,1,50,0,0,0.00355871886120996,281
32,24,8,5,11,1,0,0.00342857142857143,2625
6,3,3,2,50,1,0,0.0050251256281407,398
3,1,2,2,50,1,0,0.0020703933747412,483
208,36,172,1,11,0,0,0.00403225806451613,248
2,1,1,1,81,0,0,0,4
3,1,2,1,15,0,0,0.00699300699300699,143
74,35,39,2,15,1,0,0.00193423597678917,517
3,1,2,1,15,0,0,0.004149377593361,241
234,117,117,3,15,2,0,0.000961538461538462,1040
3,1,2,1,15,0,0,0.00604229607250755,331
1,1,0,1,15,0,0,0.0192307692307692,52
8,4,4,1,34,1,0,0.00185185185185185,540
3,1,2,1,15,0,0,0.00510204081632653,196
37,18,19,1,15,0,0,0.00118906064209275,841
3,1,2,1,15,0,0,0.00363636363636364,275
3,1,2,1,15,0,0,0.0015527950310559,644
3,1,2,1,15,0,0,0.00271739130434783,368
18,15,3,3,72,2,0,0.000896592946802152,3346
6,6,0,2,69,1,0,0.00225394440270473,1331
6,2,4,1,84,0,0,0.0121212121212121,165
6,3,3,1,53,0,0,0.00201207243460765,2485
0,0,0,1,84,0,0,0.00684931506849315,146
3,1,2,2,63,1,0,0.0131578947368421,76
12,6,6,2,15,0,0,0.00104329681794471,1917
15,14,1,2,53,0,0,0.00666666666666667,150
34,34,0,1,62,0,0,0,142
518,325,193,7,6,2,0,0,422
28,24,4,4,6,1,0,0,184
47,24,23,3,24,1,0,0.000831255195344971,1203
31,18,13,5,6,1,0,0.00214362272240086,933
2,1,1,1,31,0,0,0,241
15,10,5,4,6,0,0,0,202
1,0,1,1,87,0,0,0,101
5,5,0,1,58,1,0,0.00651465798045603,307
2,1,1,1,31,0,0,0,189
53,26,27,2,29,1,0,0.00204081632653061,490
72,54,18,5,23,3,0,0,278
8,8,0,1,23,1,0,0,171
19,10,9,2,22,1,0,0,451
2,1,1,1,59,1,0,0,76
21,18,3,2,31,1,0,0,349
6,5,1,2,59,2,0,0,193
2,2,0,1,59,1,0,0,48
63,46,17,3,14,1,0,0,276
4,4,0,1,62,0,0,0,97
56,52,4,6,6,3,0,0.00300075018754689,1333
7,6,1,2,6,0,0,0.00458715596330275,218
4,2,2,1,31,0,0,0,228
3,2,1,1,31,0,0,0,43
3,1,2,2,86,1,0,0,112
2,1,1,1,84,1,0,0,65
6,3,3,1,24,0,0,0,113
2,1,1,1,84,1,0,0,66
31,23,8,2,53,2,0,0,126
1,1,0,1,52,1,0,0,174
1,1,0,1,48,0,0,0,146
12,12,0,2,52,1,0,0,159
8,2,6,1,52,0,0,0,165
16,8,8,2,5,1,0,0,108
2,1,1,1,31,0,0,0,237
2,1,1,1,77,0,0,0.0238095238095238,84
2,1,1,1,77,0,0,0,58
16,0,16,1,73,1,0,0,125
6,0,6,1,73,1,0,0,225
74,45,29,4,23,2,0,0.00136239782016349,734
2,1,1,1,71,0,0,0,97
71,44,27,9,31,3,0,0.00149476831091181,669
5,4,1,1,6,1,0,0,67
99,69,30,7,6,6,0,0,388
10,7,3,3,55,3,0,0,153
3,3,0,1,55,0,0,0,179
0,0,0,1,56,1,0,0,59
0,0,0,1,56,1,0,0,25
58,55,3,2,51,2,0,0,180
1,1,0,1,51,1,0,0,29
4,2,2,1,31,0,0,0,43
0,0,0,2,58,1,0,0,0
0,0,0,2,58,1,0,0,0
24,12,12,1,24,0,0,0,512
22,11,11,1,24,0,0,0,643
32,16,16,1,24,0,0,0,144
8,4,4,1,89,0,0,0,99
20,10,10,1,89,0,0,0,218
58,37,21,4,36,1,0,0.0028328611898017,706
20,10,10,1,89,0,0,0.00248756218905473,402
19,12,7,3,5,0,0,0.00269541778975741,371
4,2,2,1,89,0,0,0.0117647058823529,85
20,10,10,2,86,0,0,0.00427350427350427,234
9,4,5,4,9,2,0,0.00389105058365759,257
12,5,7,1,89,0,0,0,147
13,8,5,1,89,0,0,0,69
175,109,66,5,41,5,0,0.00364963503649635,548
6,6,0,1,88,1,0,0.0144927536231884,138
4,2,2,1,84,1,0,0.0169491525423729,59
5,5,0,1,57,1,0,0.0169491525423729,59
12,1,11,1,52,0,0,0,60
9,6,3,1,53,0,0,0,64
4,2,2,1,51,0,0,0.00581395348837209,172
3,2,1,1,51,0,0,0.0147058823529412,68
5,3,2,1,51,0,0,0.0166666666666667,60
67,62,5,5,5,1,0,0.015625,64
33,23,10,4,5,0,0,0.0114942528735632,87
2,1,1,1,71,0,0,0,53
40,5,35,1,5,0,0,0.00689655172413793,145
0,0,0,2,5,0,0,0,0
0,0,0,2,5,0,0,0,0
30,21,9,2,5,2,0,0,201
2,2,0,1,5,1,0,0.00917431192660551,109
50,33,17,6,5,5,0,0,360
7,6,1,1,79,0,0,0,156
2,1,1,1,84,1,0,0.00909090909090909,110
2,1,1,1,84,1,0,0.0727272727272727,55
7,6,1,2,61,2,0,0.00628930817610063,159
9,8,1,1,61,1,0,0.0129032258064516,155
2,1,1,1,77,0,0,0.00306748466257669,1304
2,1,1,1,77,0,0,0.00369685767097967,541
2,1,1,1,73,0,0,0,81
2,1,1,1,84,1,0,0,1091
77,54,23,5,8,4,0,0.00413223140495868,1452
72,39,33,2,63,1,0,0.00213675213675214,936
2,1,1,1,50,1,0,0,71
1,1,0,1,63,1,0,0,179
18,10,8,2,55,0,0,0.0217391304347826,184
16,16,0,1,9,1,0,0,152
5,5,0,1,44,1,0,0,177
7,7,0,1,44,1,0,0.00526315789473684,190
252,142,110,11,8,3,0,0.0072992700729927,548
29,12,17,2,36,1,0,0,206
20,13,7,2,35,1,0,0,131
15,13,2,1,71,0,0,0.00452488687782805,221
23,13,10,1,44,1,0,0.00816326530612245,245
11,9,2,2,44,2,0,0.00344827586206897,290
5,3,2,2,5,1,0,0.028169014084507,71
2,1,1,1,84,1,0,0.00355871886120996,281
14,6,8,1,65,0,0,0.00389105058365759,257
75,64,11,7,0,4,0,0.00230149597238205,869
2,1,1,1,10,1,0,0,94
60,33,27,1,89,0,0,0,233
2,1,1,1,50,1,0,0,127
1,1,0,1,1,1,0,0,83
54,45,9,1,36,1,0,0.00552486187845304,181
16,16,0,1,36,1,0,0.0113636363636364,88
152,99,53,2,36,2,0,0.00613496932515337,163
3,3,0,1,49,1,0,0.0128205128205128,78
36,30,6,3,35,3,0,0,71
7,6,1,1,36,1,0,0,52
54,54,0,4,5,1,0,0.00347222222222222,288
2,2,0,2,5,1,0,0,25
27,21,6,1,36,1,0,0.00716845878136201,279
130,127,3,3,54,0,0,0.00440528634361234,227
1,1,0,1,55,0,0,0,16
233,232,1,2,49,1,0,0.00240384615384615,416
4,4,0,2,49,1,0,0,42
6,3,3,2,37,1,0,0.0032258064516129,620
12,9,3,1,41,1,0,0,160
17,14,3,1,57,1,0,0,67
1,1,0,1,57,1,0,0,56
64,44,20,1,57,1,0,0,136
5,5,0,1,57,1,0,0,77
8,8,0,1,57,1,0,0,91
0,0,0,1,77,0,0,0,56
0,0,0,1,77,0,0,0,45
0,0,0,1,77,0,0,0.0147058823529412,68
0,0,0,1,77,0,0,0,65
26,18,8,5,15,2,0,0.00465116279069767,215
9,6,3,4,15,1,0,0,83
0,0,0,1,77,0,0,0.00366300366300366,273
0,0,0,1,77,0,0,0,110
186,108,78,5,15,0,0,0.00719424460431655,139
25,14,11,4,15,0,0,0,50
0,0,0,1,77,0,0,0.00743494423791822,269
0,0,0,1,77,0,0,0,160
0,0,0,1,77,0,0,0.00444444444444444,225
0,0,0,1,77,0,0,0,105
0,0,0,1,77,0,0,0,49
0,0,0,1,77,0,0,0,40
0,0,0,1,77,0,0,0.00689655172413793,145
0,0,0,1,77,0,0,0,90
6,3,3,3,24,2,0,0.00540540540540541,185
0,0,0,1,77,0,0,0,85
0,0,0,1,77,0,0,0,83
0,0,0,1,77,0,0,0,40
0,0,0,1,77,0,0,0,60
0,0,0,1,77,0,0,0,43
4,3,1,2,75,1,0,0.00694444444444444,144
0,0,0,1,77,0,0,0,65
0,0,0,1,77,0,0,0.00483091787439614,207
0,0,0,1,77,0,0,0,93
0,0,0,1,77,0,0,0.0078740157480315,127
0,0,0,1,77,0,0,0,76
0,0,0,1,77,0,0,0.00266666666666667,375
0,0,0,1,77,0,0,0,60
0,0,0,1,77,0,0,0.000967117988394584,1034
0,0,0,1,77,0,0,0,154
0,0,0,1,77,0,0,0.0192307692307692,52
0,0,0,1,77,0,0,0,51
0,0,0,1,77,0,0,0.0126582278481013,79
0,0,0,1,77,0,0,0,49
0,0,0,1,77,0,0,0,38
7,6,1,2,63,1,0,0.00958466453674121,313
36,33,3,5,49,3,0,0.00256081946222791,781
10,10,0,2,49,1,0,0,327
17,9,8,3,36,2,0,0.00159744408945687,626
5,5,0,1,49,1,0,0.00142045454545455,704
41,22,19,1,44,1,0,0,290
0,0,0,1,63,1,0,0.024390243902439,41
0,0,0,1,63,1,0,0.0256410256410256,39
3,3,0,1,33,1,0,0.0106382978723404,94
2,2,0,1,33,1,0,0,53
0,0,0,1,63,1,0,0.0294117647058824,34
0,0,0,1,63,1,0,0.0263157894736842,38
48,25,23,8,6,3,0,0.000898472596585804,1113
12,8,4,2,49,0,0,0,266
5,4,1,1,33,1,0,0.0176991150442478,113
4,3,1,1,24,0,0,0,222
12,10,2,1,16,0,0,0,74
2,2,0,1,16,0,0,0,47
2,1,1,1,79,0,0,0.0173913043478261,115
2,1,1,1,79,0,0,0.00714285714285714,140
0,0,0,1,84,0,0,0,0
0,0,0,1,84,0,0,0,0
0,0,0,1,84,0,0,0,0
0,0,0,1,84,0,0,0,0
0,0,0,1,84,0,0,0,0
0,0,0,1,84,0,0,0,0
0,0,0,1,84,0,0,0,0
0,0,0,1,84,0,0,0,0
0,0,0,1,84,0,0,0,0
0,0,0,1,84,0,0,0,0
0,0,0,1,84,0,0,0,0
0,0,0,1,84,0,0,0,0
0,0,0,1,84,0,0,0,0
0,0,0,1,84,0,0,0,0
0,0,0,1,84,0,0,0,0
2,1,1,1,10,1,0,0,93
0,0,0,1,63,1,0,0,45
0,0,0,1,63,1,0,0,50
13,13,0,1,59,0,0,0,117
8,5,3,2,59,1,0,0.010752688172043,93
20,10,10,1,27,1,0,0,218
6,3,3,1,79,1,0,0,129
8,4,4,1,79,1,0,0.00840336134453781,119
37,31,6,2,6,1,0,0.00224719101123596,445
13,12,1,2,6,1,0,0,237
2,1,1,1,20,0,0,0.00602409638554217,166
4,2,2,1,45,1,0,0,133
783,336,447,14,1,7,0,0.00185701021355617,1077
15,11,4,4,25,1,0,0,253
0,0,0,1,34,1,0,0,189
0,0,0,1,61,0,0,0,0
0,0,0,1,61,0,0,0,0
25,15,10,4,44,3,0,0.00408163265306122,245
4,2,2,2,78,1,0,0,180
2,1,1,1,89,0,0,0,87
112,88,24,10,1,5,0,0.00898203592814371,334
10,10,0,2,1,1,0,0.00970873786407767,103
39,39,0,2,1,1,0,0.00480769230769231,208
10,10,0,2,1,1,0,0.0114942528735632,87
111,48,63,4,1,2,0,0.00735294117647059,136
6,5,1,2,1,1,0,0.012987012987013,77
340,211,129,14,1,7,0,0.0043525571273123,919
10,0,10,1,20,0,0,0,144
108,79,29,5,1,1,0,0.00199600798403194,501
14,8,6,1,52,0,0,0.00270513976555455,1109
3,2,1,1,52,0,0,0,84
12,10,2,2,44,2,0,0.01,100
21,10,11,3,43,1,0,0.000803212851405623,1245
6,3,3,1,43,0,0,0,545
1,0,1,1,84,0,0,0,163
149,49,100,4,27,1,0,0.0017996400719856,1667
34,9,25,1,27,1,0,0.00174520069808028,573
160,68,92,4,30,1,0,0.0015220700152207,657
15,0,15,1,59,0,0,0.00113765642775882,879
15,5,10,1,51,0,0,0.00294117647058824,340
2,1,1,1,84,1,0,0,151
13,1,12,1,59,0,0,0.0018450184501845,542
2,1,1,1,84,1,0,0,221
6,3,3,2,53,0,0,0,260
0,0,0,1,84,0,0,0,0
0,0,0,1,84,0,0,0,0
0,0,0,1,83,0,0,0.00740740740740741,135
0,0,0,1,83,0,0,0,68
8,5,3,2,10,0,0,0.00342465753424658,292
781,427,354,11,15,3,0,0.0138248847926267,217
14,8,6,1,71,1,0,0,53
59,38,21,9,24,3,2,0.000817661488143908,2446
18,7,11,4,50,2,1,0.000991080277502478,1009
4,2,2,2,26,0,0,0.00268096514745308,373
18,14,4,1,64,1,0,0.00206611570247934,484
526,241,285,3,29,1,0,0.0020703933747412,483
67,33,34,3,29,1,0,0,77
9,8,1,2,11,0,0,0,140
0,0,0,1,84,0,0,0,65
37,18,19,2,83,0,0,0.0142857142857143,70
15,7,8,2,83,0,0,0,47
197,93,104,2,83,0,0,0.00529100529100529,189
46,21,25,2,83,0,0,0,135
0,0,0,1,83,0,0,0.0161290322580645,62
0,0,0,1,83,0,0,0,47
6,2,4,1,60,1,0,0,74
8,8,0,1,60,1,0,0,65
4,3,1,1,40,1,0,0,245
12,9,3,2,40,2,0,0,536
5,5,0,1,40,1,0,0,93
2,1,1,1,40,1,0,0,103
21,0,21,1,53,0,0,0,179
11,0,11,1,53,0,0,0,95
69,34,35,2,83,0,0,0.00694444444444444,144
78,38,40,2,83,0,0,0,88
31,20,11,8,32,5,0,0.000523834468308015,1909
0,0,0,1,83,0,0,0.00272479564032698,367
0,0,0,1,83,0,0,0,96
4,2,2,1,83,0,0,0,346
21,10,11,3,62,0,0,0,55
50,28,22,4,57,0,0,0,51
13,6,7,2,83,0,0,0,45
69,33,36,5,53,1,0,0,169
14,9,5,3,53,0,0,0,129
0,0,0,1,83,0,0,0.0045662100456621,219
0,0,0,1,83,0,0,0,61
6,3,3,2,52,1,0,0.000828500414250207,1207
18,12,6,1,52,1,0,0,198
0,0,0,1,6,0,0,0,67
0,0,0,1,6,0,0,0,60
0,0,0,1,83,0,0,0,73
0,0,0,1,83,0,0,0,88
0,0,0,1,83,0,0,0.00190114068441065,526
0,0,0,1,83,0,0,0,76
0,0,0,1,83,0,0,0,112
0,0,0,1,83,0,0,0,79
0,0,0,1,83,0,0,0,293
0,0,0,1,83,0,0,0,75
0,0,0,1,83,0,0,0,38
0,0,0,1,83,0,0,0,38
0,0,0,1,83,0,0,0.00561797752808989,178
0,0,0,1,83,0,0,0,72
143,68,75,5,15,1,0,0.0101010101010101,99
1,0,1,4,15,1,0,0,0
0,0,0,3,15,1,0,0,0
0,0,0,3,15,1,0,0,0
0,0,0,3,15,1,0,0,57
0,0,0,1,83,0,0,0.00961538461538462,104
0,0,0,1,83,0,0,0,118
0,0,0,1,83,0,0,0.0208333333333333,48
3,2,1,2,83,0,0,0,102
40,24,16,4,56,2,0,0.00182149362477231,549
1,1,0,1,57,1,0,0,50
0,0,0,1,16,0,0,0.00662251655629139,151
0,0,0,1,16,0,0,0,52
38,19,19,5,25,0,0,0,79
0,0,0,1,83,0,0,0.00347222222222222,288
0,0,0,1,83,0,0,0,49
1,1,0,1,63,0,0,0.00961538461538462,104
61,42,19,3,20,2,0,0,725
9,7,2,3,20,2,0,0,162
67,35,32,2,29,1,0,0,126
4,2,2,1,29,1,0,0,126
2,1,1,1,84,1,0,0,101
12,6,6,2,15,2,0,0.00656455142231947,457
4,2,2,1,28,1,0,0,122
2,1,1,1,84,0,0,0.00248138957816377,806
0,0,0,1,84,0,0,0,289
0,0,0,1,84,0,0,0,269
0,0,0,1,84,0,0,0,147
0,0,0,1,84,0,0,0,131
0,0,0,1,84,0,0,0,143
0,0,0,1,84,0,0,0,104
0,0,0,1,84,0,0,0,401
0,0,0,1,84,0,0,0,140
0,0,0,1,84,0,0,0,197
0,0,0,1,84,0,0,0,132
0,0,0,1,84,0,0,0,148
0,0,0,1,84,0,0,0,156
0,0,0,1,84,0,0,0,448
0,0,0,1,84,0,0,0,212
1,0,1,1,35,1,0,0,152
113,55,58,2,35,2,0,0.00344234079173838,581
109,82,27,1,35,1,0,0.0066006600660066,303
124,95,29,4,26,3,0,0.00191938579654511,521
19,18,1,2,26,1,0,0.00131578947368421,760
50,44,6,2,14,2,0,0.00529100529100529,378
18,4,14,1,35,1,0,0,62
3,0,3,1,35,1,0,0,57
103,54,49,6,28,2,0,0.0154142581888247,519
3,2,1,2,69,0,0,0.00378787878787879,264
7,2,5,2,28,1,0,0,44
1,1,0,1,0,0,0,0,153
14,5,9,1,35,1,0,0,65
2,0,2,1,35,1,0,0,128
143,74,69,4,28,3,0,0,120
41,20,21,1,35,1,0,0,65
10,8,2,2,89,0,0,0,322
182,11,171,4,55,2,0,0.00986842105263158,304
1,0,1,1,12,1,0,0,138
18,13,5,2,28,0,0,0,119
0,0,0,1,0,1,0,0,69
3,1,2,2,0,2,0,0,69
3,3,0,1,0,1,0,0,59
112,112,0,1,14,1,0,0.00900900900900901,222
2,2,0,1,14,1,0,0,35
7,6,1,1,60,0,0,0.0128205128205128,78
6,6,0,1,35,1,0,0.00649350649350649,154
1,1,0,1,35,1,0,0,16
0,0,0,4,27,0,0,0,0
0,0,0,4,27,0,0,0,0
0,0,0,4,27,0,0,0,0
0,0,0,4,27,0,0,0,0
0,0,0,4,27,0,0,0,0
0,0,0,4,27,0,0,0,0
0,0,0,4,27,0,0,0,0
0,0,0,6,20,0,0,0,0
0,0,0,6,20,0,0,0,0
0,0,0,2,20,0,0,0,0
0,0,0,2,20,0,0,0,0
0,0,0,2,20,0,0,0,0
0,0,0,2,20,0,0,0,0
0,0,0,2,20,0,0,0,0
0,0,0,2,20,0,0,0,0
0,0,0,2,20,0,0,0,0
0,0,0,6,20,0,0,0,0
0,0,0,6,20,0,0,0,0
0,0,0,6,20,0,0,0,0
0,0,0,6,20,0,0,0,0
0,0,0,2,27,0,0,0,0
0,0,0,2,27,0,0,0,0
0,0,0,6,20,0,0,0,0
0,0,0,6,20,0,0,0,0
0,0,0,6,20,0,0,0,0
0,0,0,6,20,0,0,0,0
0,0,0,6,20,0,0,0,0
0,0,0,6,20,0,0,0,0
0,0,0,6,20,0,0,0,0
0,0,0,6,20,0,0,0,0
0,0,0,6,20,0,0,0,0
0,0,0,6,20,0,0,0,0
0,0,0,6,20,0,0,0,0
31,20,11,3,53,2,0,0.00291545189504373,343
5,5,0,1,54,0,0,0.00581395348837209,172
2,1,1,1,54,0,0,0.0104166666666667,96
6,4,2,2,57,2,0,0,807
0,0,0,1,64,1,0,0,42
0,0,0,1,64,1,0,0,32
2,2,0,1,30,0,0,0,517
5,4,1,1,64,1,0,0.00381679389312977,262
0,0,0,1,77,0,0,0.00581395348837209,172
0,0,0,1,77,0,0,0,67
0,0,0,1,77,0,0,0,0
0,0,0,1,77,0,0,0,0
16,12,4,3,39,1,0,0.0012970168612192,771
0,0,0,1,77,0,0,0,143
0,0,0,1,77,0,0,0,118
0,0,0,1,77,0,0,0,40
0,0,0,1,77,0,0,0,0
0,0,0,1,77,0,0,0,0
147,114,33,4,24,1,0,0,163
36,27,9,4,24,1,0,0,133
0,0,0,1,77,0,0,0,132
0,0,0,1,77,0,0,0,60
25,13,12,3,24,1,0,0,314
0,0,0,1,77,0,0,0,72
12,6,6,2,24,0,0,0,145
0,0,0,1,77,0,0,0,52
22,11,11,4,39,1,0,0.00313479623824451,319
0,0,0,1,77,0,0,0,139
0,0,0,1,77,0,0,0.00873362445414847,229
0,0,0,1,77,0,0,0,129
0,0,0,1,77,0,0,0.00297619047619048,336
0,0,0,1,77,0,0,0,165
0,0,0,1,77,0,0,0.00520833333333333,192
0,0,0,1,77,0,0,0,147
0,0,0,1,77,0,0,0.00662251655629139,151
0,0,0,1,77,0,0,0,49
0,0,0,1,77,0,0,0,0
0,0,0,1,77,0,0,0,0
0,0,0,1,77,0,0,0,0
0,0,0,1,77,0,0,0,0
0,0,0,1,84,0,0,0,0
0,0,0,1,84,0,0,0,0
0,0,0,1,77,0,0,0,0
0,0,0,1,77,0,0,0,0
0,0,0,1,77,0,0,0,0
0,0,0,1,77,0,0,0,0
0,0,0,1,77,0,0,0,0
0,0,0,1,77,0,0,0,0
0,0,0,1,77,0,0,0,0
0,0,0,1,77,0,0,0,0
0,0,0,1,77,0,0,0,0
0,0,0,1,77,0,0,0,0
0,0,0,1,77,0,0,0,0
0,0,0,1,77,0,0,0,0
0,0,0,1,77,0,0,0,0
0,0,0,1,77,0,0,0,0
0,0,0,1,77,0,0,0,0
0,0,0,1,77,0,0,0,0
0,0,0,1,77,0,0,0,0
0,0,0,1,77,0,0,0,0
0,0,0,1,77,0,0,0,0
0,0,0,1,77,0,0,0,0
0,0,0,1,77,0,0,0,0
0,0,0,1,77,0,0,0,0
0,0,0,1,77,0,0,0,0
0,0,0,1,77,0,0,0,0
0,0,0,1,84,0,0,0,0
0,0,0,1,84,0,0,0,0
0,0,0,1,84,0,0,0,0
0,0,0,1,84,0,0,0,0
0,0,0,1,84,0,0,0,0
0,0,0,1,84,0,0,0,0
0,0,0,1,84,0,0,0,0
0,0,0,1,84,0,0,0,0
0,0,0,1,77,0,0,0,0
0,0,0,1,77,0,0,0,0
0,0,0,1,77,0,0,0,0
0,0,0,1,77,0,0,0,0
0,0,0,1,77,0,0,0,0
12,1,11,1,63,1,0,0,45
0,0,0,1,84,0,0,0,0
0,0,0,1,84,0,0,0,0
0,0,0,1,83,0,0,0,0
0,0,0,1,83,0,0,0,0
0,0,0,1,83,0,0,0,0
0,0,0,1,83,0,0,0,0
4,2,2,3,83,1,0,0,0
0,0,0,1,83,0,0,0,0
0,0,0,1,83,0,0,0,0
0,0,0,1,83,0,0,0,0
0,0,0,1,83,0,0,0,0
0,0,0,1,83,0,0,0,0
0,0,0,1,83,0,0,0,0
0,0,0,1,83,0,0,0,0
0,0,0,1,83,0,0,0,0
0,0,0,1,83,0,0,0,0
0,0,0,1,83,0,0,0,0
0,0,0,1,83,0,0,0,0
0,0,0,1,83,0,0,0,0
0,0,0,1,83,0,0,0,0
0,0,0,1,83,0,0,0,0
0,0,0,1,83,0,0,0,0
0,0,0,1,77,0,0,0,0
0,0,0,1,77,0,0,0,0
0,0,0,1,77,0,0,0,0
0,0,0,1,77,0,0,0,0
0,0,0,1,77,0,0,0,0
0,0,0,1,77,0,0,0,0
0,0,0,1,77,0,0,0,0
0,0,0,1,77,0,0,0,0
0,0,0,1,83,0,0,0,0
0,0,0,1,83,0,0,0,0
0,0,0,1,83,0,0,0,0
0,0,0,1,83,0,0,0,0
0,0,0,1,83,0,0,0,0
0,0,0,1,83,0,0,0,0
0,0,0,1,83,0,0,0,0
0,0,0,1,83,0,0,0,0
0,0,0,1,83,0,0,0,0
0,0,0,1,83,0,0,0,0
0,0,0,1,83,0,0,0,0
0,0,0,1,77,0,0,0,0
0,0,0,1,77,0,0,0,0
0,0,0,1,77,0,0,0,0
0,0,0,1,77,0,0,0,0
0,0,0,1,77,0,0,0,0
0,0,0,1,77,0,0,0,0
0,0,0,1,77,0,0,0,0
0,0,0,1,77,0,0,0,0
0,0,0,1,77,0,0,0,0
0,0,0,1,77,0,0,0,0
0,0,0,1,77,0,0,0,0
0,0,0,1,77,0,0,0,0
0,0,0,1,77,0,0,0.0222222222222222,45
0,0,0,1,77,0,0,0,35
0,0,0,1,77,0,0,0.00813008130081301,123
0,0,0,1,77,0,0,0,38
0,0,0,1,77,0,0,0,0
0,0,0,1,77,0,0,0,0
0,0,0,1,77,0,0,0,0
0,0,0,1,77,0,0,0,0
0,0,0,1,77,0,0,0,0
0,0,0,1,77,0,0,0,0
0,0,0,1,77,0,0,0,0
0,0,0,1,77,0,0,0,0
0,0,0,1,77,0,0,0,0
0,0,0,1,77,0,0,0,0
24,11,13,3,16,0,0,0,620
4,3,1,2,77,0,0,0,158
77,41,36,2,16,0,0,0,145
126,17,109,2,16,0,0,0.0178571428571429,56
7,0,7,1,16,0,0,0.0181818181818182,55
2,0,2,1,16,0,0,0,44
226,188,38,3,16,0,0,0.00173611111111111,576
113,11,102,3,16,0,0,0,102
0,0,0,1,16,0,0,0,43
0,0,0,1,16,0,0,0,39
0,0,0,1,16,0,0,0,44
0,0,0,1,16,0,0,0,42
337,178,159,9,38,5,0,0.008,375
11,4,7,2,61,2,0,0.00980392156862745,102
30,15,15,4,3,3,0,0.000786163522012579,1272
71,61,10,1,20,0,0,0.0020703933747412,483
6,5,1,1,20,0,0,0.0121951219512195,82
0,0,0,1,20,0,0,0.0147058823529412,68
0,0,0,1,20,0,0,0.0175438596491228,57
4,2,2,2,8,0,0,0,3
22,13,9,2,9,0,0,0.0192307692307692,52
0,0,0,1,84,0,0,0.0222222222222222,45
0,0,0,1,84,0,0,0,52
0,0,0,1,84,0,0,0,41
0,0,0,1,84,0,0,0,45
0,0,0,1,84,0,0,0,51
0,0,0,1,84,0,0,0,38
0,0,0,1,84,0,0,0,115
0,0,0,1,84,0,0,0,47
0,0,0,1,84,0,0,0,93
0,0,0,1,84,0,0,0,71
4,2,2,1,26,0,0,0,560
22,11,11,3,63,1,0,0,427
14,7,7,1,89,0,0,0,122
22,11,11,1,89,0,0,0.00917431192660551,109
22,11,11,1,89,0,0,0,60
6,3,3,1,84,0,0,0.00290697674418605,344
0,0,0,1,9,0,0,0.00282485875706215,354
0,0,0,1,9,0,0,0,60
67,63,4,2,5,0,0,0.00483091787439614,621
3,3,0,2,5,0,0,0.00970873786407767,103
0,0,0,1,9,0,0,0,48
0,0,0,1,9,0,0,0,36
0,0,0,1,9,0,0,0.003125,320
0,0,0,1,9,0,0,0,90
2,1,1,1,84,1,0,0,170
4,2,2,1,84,1,0,0,104
2,1,1,1,71,1,0,0,513
10,5,5,1,62,0,0,0.00220264317180617,454
2,1,1,1,73,0,0,0,72
6,3,3,1,89,0,0,0,48
3,2,1,2,54,2,0,0,223
24,12,12,1,89,0,0,0,75
10,5,5,1,89,0,0,0,43
16,8,8,1,89,0,0,0,62
3,1,2,1,89,0,0,0,36
5,3,2,1,89,0,0,0,34
227,149,78,28,24,18,0,0.00280583613916947,1782
1,1,0,1,55,0,0,0.0118343195266272,169
3,1,2,2,77,1,0,0,458
38,35,3,3,55,2,0,0.00340715502555366,587
9,9,0,1,55,0,0,0,314
104,79,25,11,22,5,0,0.00223713646532438,447
8,8,0,1,63,1,0,0.0078740157480315,127
13,10,3,1,80,1,0,0.0232558139534884,86
340,157,183,26,1,13,1,0.001953125,2048
32,13,19,9,1,4,0,0.00306748466257669,326
2,1,1,1,84,1,0,0.00320512820512821,312
0,0,0,1,1,1,0,0.00689655172413793,290
0,0,0,1,1,1,0,0.0158730158730159,63
0,0,0,1,1,1,0,0.0137931034482759,145
0,0,0,1,1,1,0,0,49
8,6,2,1,1,1,0,0.0188679245283019,53
7,6,1,1,1,1,0,0.0232558139534884,86
2,2,0,1,45,1,0,0,157
1,1,0,1,45,1,0,0.0133333333333333,75
30,15,15,1,43,0,0,0,244
2,1,1,1,43,0,0,0,128
4,2,2,1,43,0,0,0,99
2,1,1,1,43,0,0,0,76
2,1,1,1,62,0,0,0,403
39,25,14,1,84,1,0,0,203
1,1,0,1,45,1,0,0,195
1,1,0,1,45,1,0,0.0135135135135135,74
27,18,9,1,88,1,0,0,221
2,2,0,1,88,0,0,0.0158730158730159,63
5,5,0,2,17,1,0,0,214
1,1,0,1,81,1,0,0,61
45,31,14,2,33,1,0,0,379
8,4,4,1,33,0,0,0,97
70,33,37,5,43,3,0,0,276
3,3,0,1,27,0,0,0,49
16,8,8,1,27,1,0,0.00111111111111111,900
1,1,0,1,77,1,0,0,115
64,63,1,2,77,1,0,0,637
4,2,2,1,78,0,0,0.00775193798449612,129
0,0,0,2,29,0,0,0,0
0,0,0,2,29,0,0,0,0
4,2,2,3,29,0,0,0,0
0,0,0,2,29,0,0,0,0
133,40,93,3,29,0,0,0,0
24,5,19,3,29,0,0,0,0
8,4,4,3,29,0,0,0,0
5,3,2,3,29,0,0,0,0
1,1,0,1,51,0,0,0,261
5,3,2,2,66,1,0,0,198
20,14,6,7,58,2,0,0.00862068965517241,116
23,15,8,2,67,0,0,0,124
3,2,1,1,84,0,0,0,64
