CODECHURN,LOCADDED,LOCDELETED,REVISIONS,AGE,BUGFIXES,REFACTORINGS,ERROR_DENSITY,LOC
0,0,0,1,48,0,0,0,0
4,2,2,2,3,0,0,0,67
42,42,0,1,74,0,0,0,1940
218,215,3,1,59,0,0,0,9465
19,19,0,1,39,0,0,0.00192678227360308,519
1,1,0,1,32,0,0,0,82
104,100,4,2,39,0,0,0.00107181136120043,933
45,40,5,1,59,0,0,0,869
3,1,2,1,3,1,0,0,404
3,1,2,1,3,1,0,0,328
3,1,2,1,3,1,0,0,284
4,1,3,1,3,1,0,0,224
3,1,2,1,3,1,0,0,217
7,3,4,1,3,1,0,0,269
3,1,2,1,3,1,0,0,631
7,3,4,1,3,1,0,0,359
2,1,1,1,3,1,0,0,1327
38,29,9,2,3,1,0,0,1071
1,0,1,1,3,1,0,0,776
4,1,3,2,3,1,0,0,418
3,1,2,1,3,1,0,0,285
5,3,2,3,3,3,0,0,619
5,1,4,1,3,1,0,0,159
2,1,1,1,3,1,0,0,492
18,8,10,3,0,1,0,0,403
13,6,7,1,3,1,0,0,1074
9,7,2,3,3,1,0,0,463
3,1,2,1,3,1,0,0,580
5,4,1,3,3,3,0,0,731
3,1,2,1,3,1,0,0,1145
3,1,2,1,3,1,0,0,298
8,4,4,3,3,1,0,0,891
19,17,2,2,3,1,0,0,369
5,1,4,1,3,1,0,0,268
4,2,2,1,3,1,0,0,504
16,11,5,4,3,4,0,0,1031
5,4,1,3,3,3,0,0,905
14,7,7,2,3,1,0,0,402
5,1,4,1,3,1,0,0,136
3,1,2,1,3,1,0,0,1040
6,1,5,1,3,1,0,0,268
4,2,2,1,3,1,0,0,555
1,0,1,1,3,1,0,0,685
1,0,1,1,3,1,0,0,655
3,1,2,1,3,1,0,0,523
4,1,3,1,3,1,0,0,290
3,1,2,1,3,1,0,0,817
7,3,4,3,3,1,0,0,373
7,2,5,1,3,1,0,0,250
1,0,1,1,3,1,0,0,543
1,0,1,1,3,1,0,0,615
3,1,2,1,3,1,0,0,331
3,1,2,1,3,1,0,0,116
24,11,13,2,82,1,0,0.00684931506849315,146
9,6,3,2,82,0,0,0.00471698113207547,212
28,15,13,2,82,0,0,0.00155763239875389,642
12,7,5,2,67,0,0,0.00208333333333333,480
3,1,2,1,82,0,0,0,173
2,1,1,1,82,0,0,0,119
11,5,6,2,67,0,0,0.00380228136882129,263
12,7,5,2,67,0,0,0,451
399,289,110,1,64,0,0,0,787
0,0,0,1,42,0,0,0,0
0,0,0,1,42,0,0,0,0
0,0,0,1,42,0,0,0,0
0,0,0,1,42,0,0,0,0
0,0,0,1,80,1,0,0,0
0,0,0,1,80,1,0,0,0
0,0,0,1,80,1,0,0,0
0,0,0,1,80,1,0,0,0
0,0,0,1,80,1,0,0,0
151,149,2,2,27,1,0,0,0
0,0,0,1,80,1,0,0,0
0,0,0,1,80,1,0,0,0
0,0,0,1,80,1,0,0,0
15,13,2,3,32,0,0,0.00374531835205993,267
4,2,2,2,33,0,0,0,120
4,2,2,2,33,0,0,0,110
4,2,2,2,33,0,0,0,117
4,2,2,2,33,0,0,0,109
4,2,2,2,33,0,0,0,109
2,1,1,1,17,0,0,0,111
4,2,2,2,33,0,0,0,116
4,2,2,2,33,0,0,0,132
59,55,4,3,18,0,0,0,348
4,2,2,2,32,0,0,0,470
17,15,2,3,14,2,0,0,249
22,12,10,4,33,2,0,0,278
7,2,5,1,34,0,0,0,412
6,4,2,4,33,2,0,0,216
4,2,2,2,3,0,0,0.00141043723554302,709
10,6,4,2,3,0,0,0,372
7,2,5,1,34,0,0,0,438
12,6,6,2,33,2,0,0,255
0,0,0,1,81,0,0,0.000521648408972353,1917
0,0,0,1,81,0,0,0,287
27,1,26,2,81,0,0,0,455
30,29,1,2,81,0,0,0,515
7,4,3,3,81,0,0,0,187
0,0,0,1,81,0,0,0,18
4,4,0,1,77,1,0,0,137
6,6,0,2,0,0,0,0,142
7,4,3,2,89,0,0,0,268
6,3,3,2,88,1,0,0,169
4,2,2,1,89,0,0,0,331
1,1,0,1,89,0,0,0,246
13,4,9,1,4,0,0,0,105
8,4,4,1,9,0,0,0,153
8,4,4,1,0,0,0,0,172
8,4,4,1,0,0,0,0,149
8,4,4,1,0,0,0,0,182
14,7,7,1,0,0,0,0,240
6,3,3,1,0,0,0,0,143
8,4,4,1,0,0,0,0,185
6,3,3,1,0,0,0,0,124
8,4,4,1,0,0,0,0,114
8,4,4,1,0,0,0,0,162
8,4,4,1,0,0,0,0,140
8,4,4,1,0,0,0,0,108
10,5,5,1,0,0,0,0,153
8,4,4,1,0,0,0,0,97
6,3,3,1,0,0,0,0,115
12,6,6,1,0,0,0,0,251
12,6,6,1,0,0,0,0,146
8,4,4,1,0,0,0,0,103
14,7,7,1,0,0,0,0,173
10,5,5,1,0,0,0,0,200
6,3,3,1,0,0,0,0,152
12,6,6,1,0,0,0,0,167
4,2,2,1,0,0,0,0,110
12,6,6,1,0,0,0,0,159
8,4,4,1,0,0,0,0,113
8,4,4,1,0,0,0,0,138
6,3,3,1,0,0,0,0,125
6,3,3,1,0,0,0,0,306
8,4,4,1,0,0,0,0,178
10,5,5,1,0,0,0,0,126
10,5,5,1,0,0,0,0,148
6,3,3,1,0,0,0,0,190
12,6,6,1,0,0,0,0,217
14,7,7,1,0,0,0,0,197
8,4,4,1,0,0,0,0,171
8,4,4,1,0,0,0,0,123
25,6,19,1,0,0,0,0,323
4,2,2,1,0,0,0,0,138
14,9,5,3,0,2,0,0,191
8,4,4,1,0,0,0,0,132
6,3,3,1,0,0,0,0,141
6,3,3,1,0,0,0,0,141
6,3,3,1,0,0,0,0,140
6,3,3,1,0,0,0,0,140
18,9,9,1,0,0,0,0,222
10,5,5,1,0,0,0,0,106
6,3,3,1,0,0,0,0,193
8,4,4,1,0,0,0,0,195
14,7,7,1,0,0,0,0,232
6,3,3,1,0,0,0,0,162
8,4,4,1,0,0,0,0,220
18,9,9,1,0,0,0,0,241
18,9,9,1,0,0,0,0,290
10,5,5,1,0,0,0,0,171
10,5,5,1,0,0,0,0,207
6,3,3,1,0,0,0,0,120
10,5,5,1,0,0,0,0,187
8,4,4,1,0,0,0,0,155
6,3,3,1,0,0,0,0,152
12,6,6,1,0,0,0,0,187
8,4,4,1,0,0,0,0,126
14,7,7,1,0,0,0,0,195
10,5,5,1,0,0,0,0,180
11,9,2,3,11,2,0,0,292
2,1,1,1,34,1,0,0,253
6,6,0,1,31,0,0,0,346
4,4,0,1,34,1,0,0,234
38,10,28,2,68,2,0,0,330
0,0,0,2,55,2,0,0,259
2,1,1,1,1,0,0,0,196
4,2,2,2,76,2,0,0,275
6,3,3,3,1,2,0,0,237
8,4,4,1,9,0,0,0,161
17,12,5,1,53,1,0,0,311
2,2,0,1,1,0,0,0,228
2,1,1,1,31,0,0,0,3734
20,20,0,1,53,0,0,0,273
6,3,3,3,1,2,0,0,197
2,0,2,2,74,2,0,0,199
6,6,0,1,72,0,0,0,301
257,137,120,2,87,0,0,0,352
87,60,27,5,1,0,0,0.00529100529100529,378
45,25,20,7,14,2,0,0,292
3,3,0,1,1,0,0,0,262
2,1,1,1,75,1,0,0,458
4,2,2,1,1,0,0,0,138
4,2,2,1,1,0,0,0,168
6,5,1,1,47,1,0,0,350
8,4,4,1,31,0,0,0,439
12,6,6,2,56,2,0,0,299
2,1,1,1,1,0,0,0,283
2,2,0,1,1,0,0,0,143
25,24,1,4,48,0,0,0,438
4,2,2,2,72,2,0,0,4100
8,5,3,1,58,1,0,0,183
7,5,2,3,16,2,0,0,478
0,0,0,1,16,0,0,0,140
2,2,0,1,1,0,0,0,209
16,8,8,2,52,2,0,0,179
16,8,8,2,52,2,0,0,207
10,5,5,1,9,0,0,0,232
5,5,0,1,61,0,0,0,179
8,4,4,3,2,1,0,0,223
4,2,2,2,32,1,0,0,208
4,2,2,2,32,1,0,0,133
4,2,2,2,32,1,0,0,119
4,2,2,2,32,1,0,0,128
6,3,3,3,2,1,0,0,121
6,3,3,3,2,1,0,0,159
4,2,2,2,32,1,0,0,150
4,2,2,2,32,1,0,0,155
4,2,2,2,32,1,0,0,159
4,2,2,2,32,1,0,0,171
4,2,2,2,32,1,0,0,182
4,2,2,2,32,1,0,0,190
4,2,2,2,32,1,0,0,171
4,2,2,2,32,1,0,0,174
2,1,1,1,2,0,0,0,117
2,1,1,1,2,0,0,0,128
4,2,2,2,32,1,0,0,141
4,2,2,2,32,1,0,0,137
4,2,2,2,32,1,0,0,147
4,2,2,2,32,1,0,0,149
4,2,2,2,32,1,0,0,143
4,2,2,2,32,1,0,0,143
4,2,2,2,32,1,0,0,143
4,2,2,2,32,1,0,0,143
4,2,2,2,32,1,0,0,148
4,2,2,2,32,1,0,0,146
4,2,2,2,32,1,0,0,137
4,2,2,2,32,1,0,0,137
4,2,2,2,32,0,0,0,142
4,2,2,2,32,0,0,0,143
4,2,2,2,32,1,0,0,143
4,2,2,2,32,1,0,0,142
4,2,2,2,32,0,0,0,139
4,2,2,2,32,1,0,0,139
4,2,2,2,32,1,0,0,159
4,2,2,2,32,1,0,0,175
4,2,2,2,32,1,0,0,146
4,2,2,2,32,1,0,0,143
4,2,2,2,32,1,0,0,139
4,2,2,2,32,1,0,0,141
4,2,2,2,32,1,0,0,145
4,2,2,2,32,1,0,0,141
4,2,2,2,32,1,0,0,140
4,2,2,2,32,1,0,0,139
0,0,0,1,76,0,0,0,0
4,2,2,2,32,1,0,0,139
4,2,2,2,32,1,0,0,139
4,2,2,2,32,1,0,0,144
4,2,2,2,32,1,0,0,149
4,2,2,2,32,1,0,0,157
4,2,2,2,32,1,0,0,170
4,2,2,2,32,1,0,0,158
4,2,2,2,32,1,0,0,171
4,2,2,2,32,1,0,0,184
4,2,2,2,32,1,0,0,140
4,2,2,2,32,1,0,0,143
4,2,2,2,32,1,0,0,140
4,2,2,2,32,1,0,0,139
4,2,2,2,32,1,0,0,157
4,2,2,2,32,1,0,0,163
4,2,2,2,32,1,0,0,151
4,2,2,2,32,1,0,0,145
4,2,2,2,32,1,0,0,104
0,0,0,1,21,0,0,0,0
0,0,0,1,21,0,0,0,0
4,2,2,2,32,1,0,0,180
4,2,2,2,32,1,0,0,142
4,2,2,2,32,1,0,0,145
6,3,3,1,9,0,0,0,147
6,3,3,1,9,0,0,0,147
6,3,3,1,7,0,0,0,147
6,3,3,1,7,0,0,0,147
6,3,3,1,7,0,0,0,144
4,2,2,2,32,1,0,0,144
4,2,2,2,32,1,0,0,159
4,2,2,2,32,1,0,0,142
4,2,2,2,32,1,0,0,151
3,0,3,1,7,0,0,0,257
4,2,2,2,32,1,0,0,203
4,2,2,2,32,1,0,0,138
4,2,2,2,32,1,0,0,138
4,2,2,2,32,1,0,0,162
4,2,2,2,32,1,0,0,172
6,3,3,3,2,1,0,0,170
4,2,2,2,32,1,0,0,149
4,2,2,2,32,1,0,0,140
2,1,1,1,2,0,0,0,179
2,1,1,1,2,0,0,0,187
4,2,2,2,32,1,0,0,261
14,7,7,3,32,1,0,0,137
9,7,2,3,32,1,0,0,166
4,2,2,2,32,1,0,0,152
4,2,2,2,32,1,0,0,137
4,2,2,2,32,1,0,0,152
4,2,2,2,32,1,0,0,174
4,2,2,2,32,1,0,0,169
4,2,2,2,32,1,0,0,146
4,2,2,2,32,1,0,0,138
4,2,2,2,32,1,0,0,142
4,2,2,2,32,1,0,0,139
4,2,2,2,32,1,0,0,151
4,2,2,2,32,1,0,0,179
4,2,2,2,32,0,0,0,176
4,2,2,2,32,1,0,0,148
4,2,2,2,32,1,0,0,142
4,2,2,2,32,1,0,0,139
4,2,2,2,32,1,0,0,141
4,2,2,2,32,1,0,0,140
18,13,5,3,18,1,0,0,140
6,3,3,1,7,0,0,0,204
4,2,2,2,32,1,0,0,141
4,2,2,2,32,1,0,0,145
4,2,2,2,32,1,0,0,141
4,2,2,2,32,1,0,0,140
4,2,2,2,32,1,0,0,139
4,2,2,2,32,1,0,0,139
4,2,2,2,32,1,0,0,149
4,2,2,2,32,1,0,0,139
2,1,1,1,2,0,0,0,134
4,2,2,1,2,0,0,0,139
0,0,0,1,45,0,0,0,131
4,2,2,2,32,1,0,0,158
4,2,2,2,32,1,0,0,191
4,2,2,2,32,1,0,0,147
55,52,3,15,11,12,0,0,487
17,14,3,6,28,5,0,0,323
4,4,0,2,32,2,0,0,332
12,6,6,1,16,0,0,0,363
6,4,2,4,2,0,0,0,401
105,67,38,3,48,1,0,0.00366300366300366,273
31,20,11,6,9,3,0,0.00169204737732657,1182
1,1,0,1,31,1,0,0,431
2,2,0,2,32,0,0,0,333
19,18,1,4,31,3,0,0,493
1,1,0,1,31,1,0,0,107
16,8,8,2,31,1,0,0,486
2,1,1,1,88,0,0,0,185
35,24,11,9,0,1,0,0.00732600732600733,546
12,5,7,3,0,0,0,0.00169491525423729,590
149,97,52,3,26,0,0,0.0247933884297521,121
0,0,0,1,46,0,0,0,97
0,0,0,1,46,0,0,0,119
0,0,0,1,46,0,0,0,619
0,0,0,1,46,0,0,0,310
0,0,0,1,46,0,0,0,342
2,1,1,1,87,0,0,0,289
921,500,421,5,80,0,0,0.00104058272632674,961
97,66,31,1,85,0,0,0.00491803278688525,610
144,112,32,6,67,0,0,0.00201005025125628,995
8,3,5,2,67,0,0,0,126
965,695,270,4,81,1,0,0,828
157,138,19,3,87,0,0,0.00546448087431694,183
79,78,1,2,66,0,0,0,337
15,9,6,3,81,0,0,0.0344827586206897,29
40,33,7,1,85,0,0,0,253
3,3,0,1,85,0,0,0.0147058823529412,68
2,1,1,1,72,1,0,0,342
1,1,0,1,87,0,0,0.00366300366300366,273
159,94,65,2,84,0,0,0.0062111801242236,483
7,4,3,1,83,0,0,0,56
185,130,55,2,83,0,0,0,175
11,11,0,1,83,0,0,0.037037037037037,27
3,2,1,1,84,0,0,0,136
2,1,1,1,84,0,0,0,47
27,22,5,1,67,0,0,0,513
2,1,1,1,67,0,0,0.0087719298245614,114
216,208,8,4,7,1,0,0.00388726919339164,1029
36,34,2,4,7,1,0,0,170
84,61,23,2,7,0,0,0.00465116279069767,430
22,16,6,2,7,0,0,0,182
0,0,0,1,7,0,0,0,0
0,0,0,1,7,0,0,0,0
166,84,82,11,7,1,0,0.00108342361863489,923
530,265,265,6,7,0,0,0,884
4,2,2,1,7,0,0,0,516
2,1,1,1,7,0,0,0,148
2,1,1,1,7,0,0,0,185
113,57,56,10,18,1,0,0.0012853470437018,778
5,3,2,1,7,0,0,0,251
2,1,1,1,7,0,0,0,181
14,7,7,1,7,0,0,0,333
35,30,5,3,7,1,0,0.00626959247648903,319
21,7,14,4,7,1,0,0,325
8,2,6,2,7,1,0,0,233
47,13,34,2,7,1,0,0,234
7,0,7,1,80,0,0,0,422
58,44,14,3,7,1,0,0.00253164556962025,395
77,61,16,6,5,3,0,0,233
16,16,0,1,7,0,0,0,77
4,4,0,1,7,0,0,0,91
7,6,1,3,25,3,0,0,519
4,4,0,1,7,1,0,0,254
1,1,0,1,7,1,0,0,224
270,124,146,5,27,0,0,0,2252
5,3,2,1,7,0,0,0,322
64,32,32,4,27,0,0,0,1136
5,3,2,2,18,1,0,0,287
299,179,120,6,18,2,0,0.00457317073170732,656
2,1,1,1,57,0,0,0,214
8,4,4,2,18,2,0,0,385
2,1,1,1,88,1,0,0,494
1,0,1,1,57,0,0,0,583
2,1,1,1,57,0,0,0,193
2,1,1,1,57,0,0,0,97
1,1,0,1,13,0,0,0,168
2,1,1,1,0,0,0,0,212
2,1,1,1,0,0,0,0,94
1138,409,729,15,7,2,0,0.000954198473282443,1048
221,75,146,8,7,1,0,0,268
236,126,110,12,5,1,0,0.00317460317460317,630
5,5,0,1,7,0,0,0,75
466,104,362,10,24,0,0,0,462
1173,639,534,22,7,2,0,0.00177567327611719,3379
32,24,8,6,7,1,0,0.0029940119760479,334
10,5,5,2,59,0,0,0,181
7,6,1,2,7,0,0,0,90
6,5,1,2,7,0,0,0,80
5,0,5,2,59,0,0,0,167
242,80,162,13,7,1,0,0,270
58,23,35,12,7,0,0,0,137
83,38,45,6,7,0,0,0,1368
67,40,27,7,7,0,0,0.0125628140703518,398
101,56,45,9,3,0,0,0.00757575757575758,264
15,10,5,4,0,0,0,0,80
126,53,73,10,7,1,0,0.000669120107059217,2989
418,203,215,13,6,0,0,0.00176991150442478,1130
35,29,6,2,7,0,0,0,250
4,4,0,1,7,0,0,0,96
335,227,108,15,7,3,0,0.000836120401337793,1196
327,241,86,5,7,0,0,0.00129198966408269,774
181,24,157,4,27,0,0,0,166
24,1,23,2,59,0,0,0,78
2,1,1,1,80,0,0,0.00142857142857143,700
219,107,112,6,9,2,0,0.00336134453781513,595
318,216,102,6,3,1,0,0.00556328233657858,719
14,0,14,2,6,0,0,0.00434782608695652,230
24,17,7,2,14,2,0,0,70
866,440,426,12,34,7,0,0,520
84,42,42,2,60,1,0,0,78
42,35,7,3,4,1,0,0.00117508813160987,851
16,4,12,2,48,0,0,0.0078125,384
80,80,0,1,57,0,0,0.00371747211895911,269
12,12,0,1,57,0,0,0,77
2,1,1,2,48,0,0,0,0
2,1,1,1,80,0,0,0,250
0,0,0,1,10,0,0,0,79
0,0,0,1,10,0,0,0,61
15,7,8,1,13,0,0,0,45
370,329,41,17,0,2,0,0,426
4,2,2,1,6,1,0,0,498
57,28,29,4,12,1,0,0,143
142,55,87,10,0,2,0,0.000632511068943707,1581
131,66,65,2,65,0,0,0,293
67,34,33,3,57,0,0,0,96
4,2,2,2,57,0,0,0,319
2,1,1,1,21,1,0,0,101
19,16,3,1,21,1,0,0,105
93,85,8,9,19,1,0,0,603
7,7,0,1,29,0,0,0,296
6,3,3,1,82,0,0,0.00531914893617021,188
2,1,1,1,82,0,0,0,24
199,102,97,6,6,2,0,0,503
2,2,0,1,57,0,0,0,140
92,52,40,2,4,1,0,0.00319488817891374,313
4,2,2,1,21,1,0,0,72
80,72,8,2,9,0,0,0.00465116279069767,215
13,11,2,1,9,0,0,0,78
91,81,10,6,10,1,0,0,113
19,14,5,2,10,0,0,0,69
0,0,0,1,9,0,0,0,102
0,0,0,1,9,0,0,0,54
98,77,21,4,4,1,0,0.00126422250316056,1582
2,1,1,1,57,0,0,0,230
4,3,1,2,0,1,0,0,77
0,0,0,1,49,0,0,0,0
53,38,15,4,81,0,0,0,167
29,28,1,3,81,1,0,0,63
822,372,450,13,20,1,0,0.00374531835205993,534
73,59,14,6,29,1,0,0,77
27,27,0,2,81,0,0,0,206
27,27,0,2,81,0,0,0,53
1500,606,894,21,4,2,0,0.00120918984280532,1654
46,37,9,7,29,1,0,0,121
174,101,73,10,27,0,0,0,243
27,27,0,3,44,0,0,0,88
0,0,0,1,29,0,0,0,0
0,0,0,1,1,0,0,0,0
0,0,0,1,1,0,0,0,0
0,0,0,1,1,0,0,0,0
12,6,6,7,0,0,0,0,0
5,4,1,3,0,0,0,0,0
6,3,3,1,14,1,0,0,92
12,1,11,2,2,1,0,0.00523560209424084,191
290,140,150,8,13,2,0,0,2036
4,2,2,1,20,0,0,0.00491400491400491,407
8,4,4,1,7,0,0,0,170
9,5,4,2,7,1,0,0,345
101,44,57,5,4,1,0,0.00206611570247934,484
107,40,67,6,27,0,0,0,1880
106,8,98,4,27,0,0,0,77
42,23,19,1,0,0,0,0,182
6,6,0,1,20,0,0,0.00763358778625954,131
93,78,15,2,20,0,0,0.00183823529411765,544
14,10,4,2,20,0,0,0.00813008130081301,123
3,3,0,1,0,0,0,0,45
0,0,0,1,83,0,0,0,47
0,0,0,1,83,0,0,0,151
0,0,0,1,83,0,0,0,55
0,0,0,1,83,0,0,0,136
0,0,0,1,83,0,0,0,31
0,0,0,1,83,0,0,0,48
30,12,18,4,0,1,0,0.00833333333333333,240
6,3,3,2,11,1,0,0.00571428571428571,350
3,2,1,3,31,1,0,0,899
0,0,0,1,83,0,0,0,114
0,0,0,1,83,0,0,0,363
0,0,0,1,83,0,0,0,86
0,0,0,1,83,0,0,0,207
0,0,0,1,83,0,0,0,375
196,88,108,10,27,1,0,0,1182
0,0,0,1,83,0,0,0,219
86,68,18,5,75,1,0,0,695
0,0,0,1,83,0,0,0,978
1,1,0,2,45,1,0,0.00668896321070234,299
0,0,0,1,83,0,0,0,80
72,47,25,6,2,2,0,0.0012531328320802,798
0,0,0,1,83,0,0,0,50
14,7,7,3,7,1,0,0,183
0,0,0,1,83,0,0,0,310
3,2,1,2,11,1,0,0,402
0,0,0,1,83,0,0,0,225
0,0,0,1,83,0,0,0,230
20,12,8,3,11,1,0,0,299
40,22,18,3,4,0,0,0,98
296,135,161,4,4,0,0,0.00321888412017167,932
0,0,0,1,83,0,0,0,36
0,0,0,1,83,0,0,0,87
12,6,6,3,34,0,0,0.00434782608695652,230
0,0,0,1,83,0,0,0,0
0,0,0,1,83,0,0,0,0
0,0,0,1,83,0,0,0,0
0,0,0,1,83,0,0,0,0
0,0,0,1,83,0,0,0,0
0,0,0,1,83,0,0,0,0
0,0,0,1,83,0,0,0,0
0,0,0,1,83,0,0,0,0
1,1,0,2,13,0,0,0,0
0,0,0,1,83,0,0,0,0
0,0,0,1,83,0,0,0,0
0,0,0,1,83,0,0,0,0
0,0,0,1,83,0,0,0,0
0,0,0,1,83,0,0,0,0
0,0,0,1,83,0,0,0,0
0,0,0,1,83,0,0,0,0
37,33,4,4,83,2,0,0,0
0,0,0,1,83,0,0,0,0
1,1,0,2,13,1,0,0,0
0,0,0,1,83,0,0,0,0
0,0,0,1,83,0,0,0,0
0,0,0,1,83,0,0,0,0
0,0,0,1,83,0,0,0,0
0,0,0,1,83,0,0,0,0
0,0,0,1,83,0,0,0,0
0,0,0,1,83,0,0,0,0
0,0,0,1,83,0,0,0,0
0,0,0,1,83,0,0,0,0
0,0,0,1,83,0,0,0,0
51,49,2,4,80,0,0,0,0
0,0,0,1,83,0,0,0,0
0,0,0,1,83,0,0,0,0
0,0,0,1,83,0,0,0,0
346,175,171,15,21,2,0,0,202
160,92,68,13,46,1,0,0,148
0,0,0,2,50,0,0,0,0
596,205,391,17,45,2,0,0.00900900900900901,111
335,143,192,9,26,1,0,0,224
52,36,16,7,26,1,0,0,199
33,14,19,4,34,1,0,0,271
8,0,8,3,58,0,0,0,48
147,86,61,13,0,2,0,0,209
30,11,19,5,26,1,0,0,595
54,23,31,6,34,1,0,0,497
46,19,27,7,26,1,0,0,388
395,188,207,15,45,0,0,0.012987012987013,154
778,432,346,44,0,4,0,0.00234466588511137,853
322,168,154,18,32,2,0,0,390
7,4,3,5,0,0,0,0,43
24,10,14,7,50,0,0,0,847
37,28,9,6,21,1,0,0,922
0,0,0,1,20,0,0,0,34
606,202,404,13,0,1,0,0,291
25,5,20,4,57,0,0,0,39
1030,415,615,13,0,1,0,0,542
56,32,24,5,46,0,0,0,262
56,40,16,7,0,1,0,0,992
15,7,8,3,57,0,0,0,94
18,13,5,6,0,1,0,0.000697836706210747,1433
0,0,0,1,59,0,0,0,126
141,78,63,8,28,0,0,0,216
4,2,2,2,57,0,0,0,76
7,1,6,3,58,0,0,0,181
122,71,51,9,45,1,0,0,169
446,207,239,15,44,1,0,0,513
271,219,52,8,45,0,0,0,208
18,7,11,5,20,0,0,0,218
0,0,0,2,58,0,0,0,0
232,176,56,4,53,0,0,0.00581395348837209,172
100,76,24,8,30,0,0,0,77
131,75,56,10,47,1,0,0,83
62,51,11,4,0,1,0,0,54
159,88,71,9,46,0,0,0,263
243,179,64,5,28,0,0,0,161
2,2,0,3,53,0,0,0,16
373,291,82,9,0,2,0,0.00429184549356223,233
408,274,134,13,32,1,0,0.00334448160535117,299
104,78,26,6,0,0,0,0.0128205128205128,78
0,0,0,2,59,0,0,0,0
0,0,0,2,59,0,0,0,0
46,41,5,3,47,0,0,0,115
150,94,56,13,0,1,0,0.00496277915632754,403
163,142,21,14,21,0,0,0.0050251256281407,199
92,76,16,5,46,0,0,0,202
611,423,188,10,0,2,0,0,262
109,68,41,5,0,2,0,0,414
1072,713,359,21,0,3,0,0.00698080279232112,573
282,149,133,17,28,2,0,0,216
27,18,9,5,32,0,0,0,122
198,112,86,7,28,0,0,0,765
456,212,244,14,45,1,0,0,333
171,86,85,14,0,2,0,0,174
19,9,10,5,56,0,0,0,98
358,189,169,11,46,1,0,0.00162074554294976,617
78,43,35,5,0,0,0,0,153
96,51,45,6,46,0,0,0,0
244,49,195,12,0,2,0,0,270
37,19,18,5,50,0,0,0,1576
264,0,264,2,46,0,0,0,1247
0,0,0,1,46,0,0,0,276
9,8,1,2,46,0,0,0,291
151,66,85,4,56,0,0,0,95
9,0,9,4,56,0,0,0,0
18,7,11,5,56,0,0,0,0
18,14,4,3,58,0,0,0,21
31,22,9,6,45,0,0,0,263
66,0,66,4,57,0,0,0,38
7,3,4,3,58,0,0,0,44
149,85,64,12,28,1,0,0.00689655172413793,145
33,27,6,7,41,0,0,0.00917431192660551,109
1840,923,917,23,0,2,0,0.000597728631201434,1673
132,74,58,10,45,2,0,0,201
228,117,111,8,45,1,0,0,232
576,320,256,21,0,3,0,0.00970873786407767,309
0,0,0,1,21,0,0,0,87
400,172,228,19,0,2,0,0,319
199,117,82,15,30,0,0,0,344
114,64,50,4,46,0,0,0,165
250,166,84,5,45,0,0,0,256
352,182,170,11,0,1,0,0.00131492439184747,1521
2335,1191,1144,15,0,2,0,0,1224
1402,194,1208,11,45,0,0,0,2032
1,0,1,2,59,0,0,0,156
260,92,168,10,32,0,0,0,366
189,95,94,7,45,0,0,0,292
61,26,35,7,33,1,0,0,334
539,199,340,12,11,2,0,0.0043859649122807,228
416,219,197,13,45,1,0,0,339
1290,416,874,15,11,3,0,0,294
28,6,22,4,58,0,0,0,0
4,1,3,3,58,0,0,0,0
40,20,20,2,46,0,0,0,1790
2,1,1,2,46,0,0,0,29
0,0,0,1,59,0,0,0,132
197,0,197,3,58,0,0,0,0
9,3,6,4,50,0,0,0,0
0,0,0,1,83,0,0,0,0
0,0,0,1,83,0,0,0,0
0,0,0,1,83,0,0,0,0
0,0,0,1,83,0,0,0,0
0,0,0,1,83,0,0,0,0
0,0,0,1,83,0,0,0,0
0,0,0,1,83,0,0,0,0
0,0,0,1,83,0,0,0,0
0,0,0,1,83,0,0,0,0
0,0,0,1,83,0,0,0,0
0,0,0,1,83,0,0,0,0
0,0,0,1,83,0,0,0,0
0,0,0,1,83,0,0,0,0
0,0,0,1,83,0,0,0,0
0,0,0,1,83,0,0,0,0
0,0,0,1,83,0,0,0,0
0,0,0,1,83,0,0,0,0
0,0,0,1,83,0,0,0,0
0,0,0,1,83,0,0,0,0
0,0,0,1,83,0,0,0,0
0,0,0,1,83,0,0,0,0
0,0,0,1,83,0,0,0,0
0,0,0,1,83,0,0,0,0
0,0,0,1,83,0,0,0,0
0,0,0,1,83,0,0,0,0
0,0,0,1,83,0,0,0,0
0,0,0,1,83,0,0,0,0
0,0,0,1,83,0,0,0,0
0,0,0,1,83,0,0,0,0
0,0,0,1,83,0,0,0,0
0,0,0,1,83,0,0,0,0
0,0,0,1,83,0,0,0,0
0,0,0,1,83,0,0,0,0
0,0,0,1,83,0,0,0,0
0,0,0,1,83,0,0,0,0
0,0,0,1,83,0,0,0,0
0,0,0,1,83,0,0,0,0
0,0,0,1,83,0,0,0,0
0,0,0,1,83,0,0,0,0
0,0,0,1,83,0,0,0,0
0,0,0,1,83,0,0,0,0
0,0,0,1,83,0,0,0,0
0,0,0,1,83,0,0,0,0
0,0,0,1,83,0,0,0,0
0,0,0,1,83,0,0,0,0
0,0,0,1,83,0,0,0,0
0,0,0,1,83,0,0,0,0
0,0,0,1,83,0,0,0,0
0,0,0,1,83,0,0,0,0
0,0,0,1,83,0,0,0,0
0,0,0,1,83,0,0,0,0
0,0,0,1,83,0,0,0,0
0,0,0,1,83,0,0,0,0
0,0,0,1,83,0,0,0,0
0,0,0,1,83,0,0,0,0
0,0,0,1,83,0,0,0,0
0,0,0,1,83,0,0,0,0
0,0,0,1,83,0,0,0,0
0,0,0,1,83,0,0,0,0
0,0,0,1,83,0,0,0,0
0,0,0,1,83,0,0,0,0
0,0,0,1,83,0,0,0,0
0,0,0,1,83,0,0,0,0
0,0,0,1,83,0,0,0,0
130,79,51,5,0,2,0,0.00527009222661397,759
39,39,0,1,32,0,0,0.00452488687782805,221
25,25,0,1,32,0,0,0.00515463917525773,194
2,1,1,1,32,0,0,0.025,40
33,33,0,1,32,0,0,0.00581395348837209,516
273,266,7,7,8,0,0,0,0
134,121,13,10,8,0,0,0,0
54,31,23,5,8,0,0,0,0
4,2,2,3,8,0,0,0,0
500,321,179,14,6,7,0,0,1318
20,16,4,3,57,0,0,0,203
2,1,1,1,62,0,0,0,108
251,10,241,3,18,0,0,0,467
2,1,1,1,62,0,0,0,73
13,10,3,2,16,0,0,0,132
5,1,4,2,41,1,0,0.00469483568075117,213
23,19,4,2,4,1,0,0.00202839756592292,493
82,23,59,7,57,0,0,0,83
205,143,62,3,57,0,0,0,384
0,0,0,1,57,0,0,0,72
121,31,90,3,57,0,0,0,149
169,95,74,3,19,1,0,0,351
10,3,7,1,19,1,0,0,99
96,61,35,3,5,0,1,0,396
10,9,1,2,5,0,1,0,72
7,3,4,2,45,1,0,0,61
8,7,1,2,45,1,0,0,56
3,1,2,2,57,0,0,0,418
0,0,0,1,60,0,0,0,95
72,69,3,3,25,1,0,0,190
20,20,0,2,60,0,0,0,155
439,309,130,7,57,0,0,0.00168067226890756,595
2,1,1,1,62,0,0,0,91
91,34,57,9,7,2,0,0.000684462696783025,1461
50,45,5,2,5,0,0,0,201
102,100,2,3,5,0,0,0,269
31,0,31,1,10,0,0,0.00666666666666667,150
43,11,32,3,14,1,0,0,82
189,62,127,11,2,3,0,0.00955414012738853,314
60,20,40,8,11,1,0,0.00632911392405063,158
0,0,0,2,5,0,0,0,71
132,8,124,5,0,1,0,0,142
0,0,0,1,10,0,0,0,0
0,0,0,1,10,0,0,0,0
61,26,35,4,10,0,0,0.00980392156862745,102
49,26,23,8,25,1,0,0.00515463917525773,194
19,10,9,4,5,1,0,0.0222222222222222,135
0,0,0,1,75,0,0,0,0
0,0,0,1,75,0,0,0,0
202,77,125,4,74,0,0,0,562
4,2,2,1,75,0,0,0,38
0,0,0,1,74,0,0,0,114
1893,1284,609,61,4,6,0,0,0
443,276,167,37,5,0,0,0,0
250,174,76,24,5,0,0,0,0
1371,638,733,30,4,2,0,0,0
0,0,0,2,74,0,0,0,0
0,0,0,2,74,0,0,0,0
0,0,0,1,8,0,0,0,0
0,0,0,1,8,0,0,0,0
0,0,0,1,8,0,0,0,0
0,0,0,1,8,0,0,0,0
128,110,18,9,5,0,0,0.0196078431372549,306
3503,1342,2161,62,4,7,1,0.00531914893617021,1504
172,129,43,15,10,2,0,0.0188679245283019,53
569,276,293,30,4,0,0,0,0
0,0,0,1,73,0,0,0,0
0,0,0,1,73,0,0,0,0
19,16,3,3,74,0,0,0,0
1529,662,867,34,5,2,0,0,0
69,39,30,8,0,3,0,0,239
20,8,12,2,41,1,0,0,114
207,121,86,12,2,4,0,0.00381679389312977,262
539,364,175,20,4,3,0,0.00735294117647059,816
11,11,0,1,17,0,0,0,62
166,120,46,7,11,3,0,0,186
94,33,61,10,4,2,0,0,110
1,1,0,1,36,1,0,0,97
20,17,3,2,60,0,0,0,142
45,23,22,3,42,0,0,0,882
9,5,4,2,42,0,0,0,428
120,81,39,7,42,0,0,0,314
24,22,2,4,54,0,0,0,404
8,4,4,4,17,1,0,0,304
0,0,0,1,74,0,0,0,151
31,0,31,2,74,0,0,0.0099009900990099,101
30,15,15,2,25,1,0,0.00116754232340922,1713
137,66,71,8,4,2,0,0.0117370892018779,426
138,97,41,9,13,0,0,0,358
41,3,38,3,75,0,0,0,71
0,0,0,1,78,0,0,0,0
37,21,16,4,19,0,0,0,85
6,4,2,2,63,0,0,0.00719424460431655,278
0,0,0,1,63,0,0,0,41
0,0,0,1,63,0,0,0,11
21,21,0,1,1,0,0,0.0164609053497942,243
3,3,0,1,1,0,0,0.0555555555555556,36
65,54,11,3,1,1,0,0.0105820105820106,189
6,6,0,1,49,0,0,0.032258064516129,62
34,2,32,2,2,1,0,0.00909090909090909,110
5,3,2,2,0,0,0,0.0131578947368421,152
4,2,2,1,25,1,0,0.0136986301369863,73
35,14,21,3,15,2,0,0,146
4,2,2,1,20,0,0,0.00217864923747277,459
1,1,0,1,15,1,0,0,72
193,64,129,6,4,1,0,0.00608519269776876,493
47,13,34,5,4,1,0,0.00574712643678161,174
12,5,7,2,0,0,0,0,80
35,3,32,3,2,2,0,0.00334448160535117,299
5,3,2,2,0,0,0,0.00645161290322581,155
8,4,4,1,25,1,0,0,124
36,17,19,4,4,2,0,0,165
4,2,2,1,46,1,0,0,261
4,2,2,1,20,0,0,0,590
1,1,0,1,15,1,0,0,140
3,3,0,1,58,0,0,0,309
47,13,34,5,4,1,0,0.00574712643678161,174
11,5,6,2,0,0,0,0,78
38,4,34,3,2,2,0,0.004739336492891,422
5,3,2,2,0,0,0,0.00649350649350649,154
8,4,4,1,25,1,0,0,124
48,23,25,4,4,2,0,0.00490196078431373,204
4,2,2,1,20,0,0,0,583
1,1,0,1,15,1,0,0,140
19,11,8,2,7,0,0,0,399
47,13,34,5,4,1,0,0.0114942528735632,174
9,4,5,2,0,0,0,0,80
75,39,36,7,2,1,0,0,838
57,18,39,3,17,0,0,0.0779220779220779,77
7,4,3,4,0,1,0,0.0467289719626168,214
142,55,87,10,27,1,0,0.00453001132502831,883
23,12,11,5,25,1,0,0.0119760479041916,167
68,36,32,8,4,2,0,0.0230414746543779,217
48,35,13,4,34,0,0,0.0203488372093023,344
15,2,13,2,2,1,0,0.00412087912087912,728
1,1,0,1,15,1,0,0.0116279069767442,86
10,9,1,1,17,0,0,0.0168067226890756,119
76,52,24,6,58,0,0,0.0115606936416185,173
47,13,34,5,4,1,0,0.0229885057471264,174
21,6,15,2,0,1,0,0.0035650623885918,561
75,39,36,7,2,1,0,0.003584229390681,837
57,18,39,3,17,0,0,0.0779220779220779,77
9,5,4,4,0,1,0,0.0425531914893617,235
11,5,6,2,0,0,0,0.0113636363636364,352
135,51,84,9,27,0,0,0.0051975051975052,962
7,4,3,2,25,1,0,0.0175438596491228,171
114,84,30,6,4,2,0,0.0187793427230047,213
15,2,13,2,2,1,0,0.00672947510094213,743
14,14,0,2,15,1,0,0.0112359550561798,89
11,9,2,2,2,1,0,0.0108108108108108,185
3,3,0,1,58,0,0,0.0171428571428571,175
47,13,34,5,4,1,0,0.0229885057471264,174
28,10,18,2,0,1,0,0.00711743772241993,562
137,57,80,9,2,1,0,0.00383877159309021,1042
0,0,0,1,49,0,0,0,0
0,0,0,1,49,0,0,0,0
40,2,38,3,2,1,0,0.0520833333333333,96
50,40,10,8,0,0,0,0.0213675213675214,234
171,102,69,7,4,2,0,0.0119047619047619,252
2093,1450,643,42,0,8,0,0.00271296798697775,3686
5,2,3,2,7,0,0,0,64
2,1,1,1,17,0,0,0,134
120,80,40,11,1,0,0,0.0110864745011086,451
2,2,0,1,1,0,0,0.0263157894736842,38
94,59,35,4,11,1,0,0.00280504908835905,713
210,150,60,12,1,1,0,0.0087527352297593,457
2,2,0,1,17,0,0,0.0050761421319797,197
377,215,162,11,11,3,0,0.00873362445414847,229
16,16,0,3,12,0,0,0,166
302,201,101,10,4,2,0,0.00294985250737463,339
521,458,63,7,0,1,0,0.00505689001264223,791
6,3,3,2,8,1,0,0.00769230769230769,130
0,0,0,1,8,0,0,0,48
3,2,1,2,61,0,0,0.00276243093922652,362
8,5,3,2,61,0,0,0,84
3,3,0,2,8,0,0,0,0
4,1,3,2,8,0,0,0,0
237,113,124,19,8,6,0,0.0483870967741935,186
156,98,58,30,5,3,0,0.0240641711229947,374
50,35,15,5,12,1,0,0.0172413793103448,174
17,10,7,5,50,1,0,0,91
1018,670,348,54,4,16,0,0.0149779735682819,1135
56,31,25,7,31,2,0,0.0196078431372549,102
27,23,4,5,60,1,0,0.0147058823529412,68
7,0,7,1,61,0,0,0,28
225,162,63,7,5,0,0,0.00431034482758621,232
56,38,18,6,5,0,0,0,71
75,47,28,5,56,0,0,0,164
4,0,4,1,61,0,0,0,35
148,95,53,12,0,2,0,0,3363
835,574,261,30,0,8,0,0.0228384991843393,613
67,37,30,4,0,1,0,0,59
213,110,103,21,0,1,0,0.0216867469879518,415
11,4,7,3,19,0,0,0.0476190476190476,63
0,0,0,1,61,0,0,0,0
0,0,0,1,25,0,0,0,64
788,575,213,40,0,16,0,0.0203619909502262,884
1723,904,819,38,2,10,0,0.00912408759124088,548
4,4,0,1,66,0,0,0,34
435,295,140,17,4,1,0,0.010752688172043,558
40,14,26,8,1,0,0,0.0225563909774436,133
6,1,5,1,61,0,0,0,30
37,23,14,5,61,0,0,0,0
1,0,1,2,61,0,0,0,0
333,214,119,17,4,5,0,0.0179640718562874,334
61,46,15,10,54,0,0,0.0241935483870968,124
113,55,58,11,5,1,2,0.00301204819277108,332
239,50,189,14,3,3,0,0,0
0,0,0,2,3,0,0,0,0
448,268,180,10,2,3,0,0.0103806228373702,289
18,10,8,3,12,2,0,0,56
81,12,69,4,17,1,0,0.0784313725490196,51
0,0,0,1,61,0,0,0,0
0,0,0,1,61,0,0,0,0
0,0,0,1,61,0,0,0,0
0,0,0,1,61,0,0,0,0
7,4,3,1,14,1,0,0,90
71,51,20,8,7,5,0,0.012779552715655,313
27,15,12,3,7,1,0,0.00609756097560976,164
49,24,25,3,0,1,0,0.0103092783505155,194
3,3,0,1,20,0,0,0.00925925925925926,108
17,10,7,3,21,0,0,0.00505050505050505,198
2,1,1,1,80,0,0,0.00420168067226891,238
86,43,43,1,75,0,0,0.00355871886120996,562
21,15,6,3,9,1,0,0,1006
16,14,2,6,7,0,0,0.0251256281407035,199
62,39,23,4,7,0,0,0.00152091254752852,1315
12,6,6,1,75,0,0,0,53
39,27,12,4,0,1,0,0.00925925925925926,216
57,28,29,3,7,0,0,0.00371747211895911,269
61,61,0,3,7,2,0,0.0179640718562874,167
72,64,8,2,11,0,0,0.00341296928327645,293
15,9,6,3,18,2,0,0,102
286,149,137,4,32,1,0,0.00105764145954521,1891
7,4,3,1,32,0,0,0.00364963503649635,274
2,1,1,1,88,1,0,0.00645161290322581,155
215,148,67,9,4,2,0,0.00601202404809619,499
16,16,0,1,85,0,0,0.02,100
33,26,7,6,4,2,0,0.0043010752688172,465
2,1,1,1,88,1,0,0.00617283950617284,162
488,285,203,9,44,1,0,0.00986842105263158,304
63,50,13,4,49,0,0,0,57
4,3,1,1,15,0,0,0.0298507462686567,67
0,0,0,1,35,0,0,0,139
0,0,0,1,35,0,0,0,1793
0,0,0,1,35,0,0,0,519
0,0,0,1,26,0,0,0,89
0,0,0,1,26,0,0,0,201
0,0,0,1,35,0,0,0,1346
0,0,0,1,35,0,0,0,46
0,0,0,1,35,0,0,0.000700770847932726,1427
0,0,0,1,35,0,0,0.00425531914893617,235
4,3,1,2,24,0,0,0.00738007380073801,271
14,8,6,4,0,2,0,0.00223214285714286,448
1,1,0,2,24,0,0,0,75
7,7,0,2,24,0,0,0.0026525198938992,377
0,0,0,1,35,0,0,0,83
0,0,0,1,35,0,0,0,297
0,0,0,1,35,0,0,0,255
0,0,0,1,35,0,0,0,158
0,0,0,1,35,0,0,0,42
0,0,0,1,35,0,0,0.0040650406504065,246
8,8,0,2,24,0,0,0,92
12,9,3,3,14,1,0,0,125
0,0,0,1,35,0,0,0,74
0,0,0,1,35,0,0,0,153
28,13,15,2,0,0,0,0,261
3,3,0,2,24,0,0,0,71
0,0,0,1,35,0,0,0,124
0,0,0,1,35,0,0,0,187
0,0,0,1,35,0,0,0,267
0,0,0,1,35,0,0,0,250
14,6,8,5,11,2,0,0.0122950819672131,244
13,0,13,2,2,1,0,0,115
2,1,1,2,24,0,0,0,189
5,5,0,2,24,0,0,0.00454545454545455,440
0,0,0,1,35,0,0,0,95
19,12,7,5,17,1,0,0.00363636363636364,825
0,0,0,1,35,0,0,0.00526315789473684,190
138,89,49,5,10,0,0,0,347
27,18,9,3,26,0,0,0,144
321,172,149,10,4,3,0,0.0018348623853211,1090
28,23,5,4,10,2,0,0.00512820512820513,195
0,0,0,1,35,0,0,0,278
0,0,0,1,35,0,0,0,95
7,4,3,3,10,2,0,0,240
3,3,0,2,24,0,0,0,458
0,0,0,1,35,0,0,0.00709219858156028,282
8,4,4,2,2,1,0,0,200
0,0,0,1,35,0,0,0,268
0,0,0,1,35,0,0,0,279
0,0,0,1,35,0,0,0,182
7,4,3,4,4,0,0,0.00833333333333333,240
0,0,0,1,35,0,0,0,52
0,0,0,1,35,0,0,0,349
2,1,1,2,7,0,0,0,170
0,0,0,1,35,0,0,0,93
11,3,8,3,2,2,0,0,242
18,16,2,4,24,0,0,0,280
0,0,0,1,35,0,0,0.00719424460431655,139
38,19,19,3,27,0,0,0,280
42,21,21,3,27,0,0,0,385
0,0,0,1,35,0,0,0.00579710144927536,345
202,101,101,5,27,0,0,0.000736377025036819,2716
0,0,0,1,35,0,0,0.00334448160535117,299
0,0,0,3,27,0,0,0,0
0,0,0,3,27,0,0,0,0
0,0,0,3,27,0,0,0,0
0,0,0,3,27,0,0,0,0
0,0,0,3,27,0,0,0,0
1168,603,565,7,16,0,0,0,1774
0,0,0,1,35,0,0,0,34
35,18,17,5,16,0,0,0,330
12,12,0,4,27,0,0,0,220
252,131,121,7,16,0,0,0,654
16,8,8,4,27,0,0,0,42
4,2,2,4,27,0,0,0,168
16,8,8,4,27,0,0,0,46
225,125,100,7,0,2,0,0.00367107195301028,1362
3,3,0,1,20,0,0,0.00900900900900901,111
4,3,1,1,62,0,0,0.0106382978723404,188
30,3,27,2,21,0,0,0.0019047619047619,525
3,0,3,1,21,0,0,0.0133333333333333,75
36,21,15,4,4,0,0,0.00114942528735632,870
11,7,4,4,4,0,0,0.00416233090530697,961
2,1,1,1,0,0,0,0,68
8,7,1,2,17,0,0,0,185
19,19,0,3,19,0,0,0,195
62,36,26,5,0,1,0,0.0106007067137809,283
151,135,16,9,7,0,0,0.00459770114942529,435
0,0,0,1,57,0,0,0,0
888,183,705,15,4,2,0,0.005,200
16,16,0,1,80,0,0,0,199
25,12,13,3,10,1,0,0,95
16,15,1,1,85,0,0,0.0161290322580645,310
415,95,320,11,7,0,1,0.00225733634311512,443
25,10,15,5,18,2,0,0.00235294117647059,425
151,144,7,3,10,0,0,0,279
51,44,7,4,49,0,0,0.00826446280991736,121
83,38,45,7,18,1,0,0,185
12,6,6,1,49,0,0,0,82
6,6,0,1,49,0,0,0.0434782608695652,69
20,10,10,1,49,0,0,0.027906976744186,215
44,29,15,7,18,2,0,0.00855920114122682,701
21,15,6,5,40,1,0,0,137
5,0,5,1,74,0,0,0.0143266475644699,349
74,0,74,3,74,2,0,0,105
141,99,42,7,18,3,0,0,443
14,7,7,5,31,2,0,0,273
1,0,1,1,82,1,0,0,195
0,0,0,1,81,0,0,0,0
0,0,0,1,81,0,0,0,0
1,0,1,2,81,0,0,0,0
0,0,0,1,81,0,0,0,0
0,0,0,1,81,0,0,0,0
0,0,0,1,81,0,0,0,0
0,0,0,1,81,0,0,0,0
0,0,0,1,81,0,0,0,0
0,0,0,1,81,0,0,0,0
0,0,0,1,81,0,0,0,0
0,0,0,1,81,0,0,0,0
0,0,0,1,81,0,0,0,0
0,0,0,1,81,0,0,0,0
0,0,0,1,81,0,0,0,0
0,0,0,1,81,0,0,0,0
0,0,0,1,81,0,0,0,0
0,0,0,1,81,0,0,0,0
0,0,0,1,81,0,0,0,0
0,0,0,1,81,0,0,0,0
0,0,0,1,81,0,0,0,0
72,45,27,6,75,4,0,0,2647
2,1,1,1,75,1,0,0.00163934426229508,1220
7,7,0,1,75,1,0,0,401
23,9,14,7,2,2,0,0,747
0,0,0,1,7,0,0,0,0
4,2,2,1,24,0,0,0,232
16,7,9,3,18,2,0,0.0165016501650165,303
1,1,0,1,7,0,0,0.0283018867924528,106
54,29,25,3,4,1,0,0,574
1,0,1,1,21,0,0,0,46
27,8,19,4,4,0,0,0.00772200772200772,259
2,1,1,1,18,0,0,0,344
2,1,1,1,24,0,0,0,13
2,1,1,1,24,0,0,0,8
2,1,1,1,24,0,0,0,8
2,1,1,1,24,0,0,0,8
2,1,1,1,24,0,0,0,8
2,1,1,1,24,0,0,0,11
2,1,1,1,24,0,0,0,15
2,1,1,1,24,0,0,0,13
2,1,1,1,24,0,0,0,15
2,1,1,1,24,0,0,0,8
2,1,1,1,24,0,0,0,11
2,1,1,1,24,0,0,0,11
2,1,1,1,24,0,0,0,10
2,1,1,1,24,0,0,0,10
2,1,1,1,24,0,0,0,8
2,1,1,1,24,0,0,0,10
2,1,1,1,24,0,0,0,15
2,1,1,1,24,0,0,0,15
2,1,1,1,24,0,0,0,13
2,1,1,1,24,0,0,0,13
2,1,1,1,24,0,0,0,15
2,1,1,1,24,0,0,0,11
2,1,1,1,24,0,0,0,8
2,1,1,1,24,0,0,0,8
2,1,1,1,24,0,0,0,8
2,1,1,1,24,0,0,0,218
2,1,1,1,24,0,0,0,15
2,1,1,1,24,0,0,0,13
2,1,1,1,24,0,0,0,23
2,1,1,1,24,0,0,0,23
2,1,1,1,24,0,0,0,16
2,1,1,1,24,0,0,0,16
2,1,1,1,24,0,0,0,11
2,1,1,1,24,0,0,0,18
2,1,1,1,24,0,0,0,23
2,1,1,1,24,0,0,0,15
2,1,1,1,24,0,0,0,18
2,1,1,1,24,0,0,0,11
2,1,1,1,24,0,0,0,14
2,1,1,1,24,0,0,0,14
2,1,1,1,24,0,0,0,13
2,1,1,1,24,0,0,0,13
2,1,1,1,24,0,0,0,11
2,1,1,1,24,0,0,0,13
2,1,1,1,24,0,0,0,18
2,1,1,1,24,0,0,0,18
2,1,1,1,24,0,0,0,16
2,1,1,1,24,0,0,0,16
2,1,1,1,24,0,0,0,15
2,1,1,1,24,0,0,0,16
2,1,1,1,24,0,0,0,12
2,1,1,1,24,0,0,0,11
2,1,1,1,24,0,0,0,13
2,1,1,1,24,0,0,0,11
2,1,1,1,24,0,0,0,247
7,4,3,1,21,0,0,0,200
4,2,2,1,24,0,0,0,320
8,4,4,1,24,0,0,0,591
5,3,2,1,21,0,0,0,180
12,6,6,3,18,1,0,0.00248447204968944,805
12,8,4,2,31,2,0,0,710
8,4,4,1,24,0,0,0,117
16,8,8,1,24,0,0,0,136
14,10,4,2,31,2,0,0,707
20,10,10,3,18,1,0,0.00458715596330275,654
16,8,8,3,18,1,0,0.00144927536231884,690
14,7,7,3,18,1,0,0.00429184549356223,699
68,38,30,5,0,2,0,0.00166666666666667,600
4,2,2,1,24,0,0,0,439
3,1,2,1,80,0,0,0.00632911392405063,158
8,6,2,2,31,2,0,0.0018348623853211,545
37,24,13,6,17,3,0,0.00702576112412178,427
244,163,81,2,13,2,0,0,1112
66,28,38,2,19,0,0,0,232
4,4,0,1,88,0,0,0,80
234,172,62,4,13,1,0,0,603
19,18,1,2,19,0,0,0,165
114,112,2,1,88,0,0,0,599
22,12,10,3,13,1,0,0.00239234449760766,418
4,4,0,1,88,0,0,0,76
58,51,7,3,41,2,0,0.00917431192660551,109
1598,552,1046,43,24,14,0,0.00172117039586919,581
9,4,5,2,25,0,0,0,36
281,169,112,13,17,3,0,0.00257731958762887,388
145,88,57,14,18,4,0,0.0048661800486618,411
895,589,306,19,9,3,0,0.00584225900681597,1027
1288,781,507,50,13,13,0,0.00177304964539007,1128
58,40,18,10,24,3,0,0.0121951219512195,82
459,333,126,18,28,8,0,0,691
36,26,10,8,35,4,0,0,59
155,56,99,6,27,0,0,0,253
1745,816,929,34,18,14,0,0.00286123032904149,699
124,83,41,16,24,5,0,0.0210526315789474,95
60,49,11,11,17,0,0,0.0102040816326531,196
886,704,182,24,11,10,0,0.00547195622435021,731
27,27,0,2,81,0,0,0,46
27,27,0,2,81,0,0,0,88
135,92,43,7,49,0,0,0,252
112,101,11,3,29,0,0,0.00512820512820513,195
167,78,89,8,16,1,0,0.00245098039215686,408
27,27,0,2,81,0,0,0,111
27,27,0,2,81,0,0,0,119
27,27,0,2,81,0,0,0,317
0,0,0,1,29,0,0,0,0
27,27,0,2,81,0,0,0,98
27,27,0,2,81,0,0,0,146
27,27,0,2,81,0,0,0,69
27,27,0,2,81,0,0,0,300
39,37,2,4,29,0,0,0.0172413793103448,58
188,111,77,8,21,0,0,0.00823045267489712,243
0,0,0,2,50,0,0,0,0
689,481,208,9,21,0,0,0,427
0,0,0,2,50,0,0,0,0
62,24,38,6,21,0,0,0.03125,64
0,0,0,2,58,0,0,0,0
0,0,0,2,58,0,0,0,0
0,0,0,2,58,0,0,0,0
0,0,0,2,58,0,0,0,0
0,0,0,2,58,0,0,0,0
772,466,306,19,0,2,0,0.00191570881226054,522
0,0,0,1,59,0,0,0,147
0,0,0,1,42,0,0,0,0
10,8,2,3,9,0,0,0.00952380952380952,210
41,28,13,1,77,0,0,0,244
12,9,3,2,75,0,0,0,154
5,3,2,2,11,2,0,0,82
2,1,1,1,83,0,0,0,78
76,64,12,8,4,2,0,0.0150375939849624,266
2,2,0,1,49,0,0,0.0294117647058824,34
112,83,29,12,3,4,0,0.00890207715133531,337
16,7,9,4,3,1,0,0.0357142857142857,84
117,99,18,9,3,2,0,0.0260223048327138,269
2,1,1,2,15,0,0,0.0632911392405063,79
292,116,176,8,3,1,0,0.02,150
5,1,4,1,19,0,0,0.0512820512820513,39
0,0,0,1,19,0,0,0.0285714285714286,105
0,0,0,1,15,0,0,0,0
0,0,0,1,15,0,0,0,0
0,0,0,1,42,0,0,0,0
0,0,0,1,35,0,0,0,274
0,0,0,1,35,0,0,0.0153846153846154,65
0,0,0,1,35,0,0,0.00336700336700337,297
0,0,0,1,35,0,0,0.0169491525423729,59
0,0,0,1,35,0,0,0,108
0,0,0,1,35,0,0,0,59
0,0,0,1,35,0,0,0,74
0,0,0,1,35,0,0,0,134
0,0,0,1,35,0,0,0.0107816711590297,371
10,10,0,3,9,1,0,0,513
0,0,0,1,35,0,0,0,79
0,0,0,1,35,0,0,0,295
12,7,5,4,18,1,0,0,61
0,0,0,1,35,0,0,0.0126582278481013,79
196,164,32,7,7,0,0,0,574
50,48,2,6,7,0,0,0,101
0,0,0,1,27,0,0,0,39
112,107,5,6,7,0,0,0,242
86,82,4,5,13,1,0,0.00561797752808989,178
63,55,8,7,7,0,0,0,1068
4,3,1,2,27,0,0,0,152
18,4,14,1,28,0,0,0,859
26,7,19,3,4,0,0,0,231
0,0,0,1,46,0,0,0,0
34,18,16,2,16,0,0,0,0
0,0,0,1,46,0,0,0,0
0,0,0,1,46,0,0,0,0
0,0,0,1,46,0,0,0,0
0,0,0,1,46,0,0,0,0
0,0,0,2,46,0,0,0,0
0,0,0,1,46,0,0,0,172
0,0,0,1,46,0,0,0,39
0,0,0,1,46,0,0,0,88
0,0,0,1,46,0,0,0,20
0,0,0,1,46,0,0,0,94
0,0,0,1,46,0,0,0,10
86,69,17,4,49,0,0,0,51
500,271,229,8,4,0,0,0,330
0,0,0,1,81,0,0,0,0
38,16,22,4,4,0,0,0.00719424460431655,278
50,21,29,5,4,0,0,0.00613496932515337,326
39,30,9,2,67,1,0,0.0175438596491228,114
1,0,1,1,83,0,0,0.142857142857143,14
0,0,0,1,83,0,0,0,0
0,0,0,1,83,0,0,0,0
0,0,0,1,83,0,0,0,0
0,0,0,1,83,0,0,0,0
0,0,0,1,83,0,0,0,0
28,9,19,4,4,0,0,0.00702576112412178,427
28,13,15,3,4,0,0,0.00865800865800866,462
28,13,15,3,4,0,0,0.0116959064327485,513
144,61,83,8,1,0,0,0,191
86,40,46,8,1,1,0,0,381
7,5,2,2,41,0,0,0,105
36,13,23,5,1,0,0,0,333
52,13,39,5,1,0,0,0,115
232,204,28,5,1,1,0,0,2823
6,4,2,3,1,0,0,0,40
64,62,2,6,1,0,0,0,182
38,34,4,6,1,0,0,0.0217391304347826,92
24,21,3,3,1,1,0,0,238
8,5,3,4,11,0,0,0,85
10,7,3,3,11,0,0,0,77
3,3,0,3,1,0,0,0,270
2,2,0,2,88,0,0,0,411
51,39,12,3,1,0,0,0.0116959064327485,171
91,40,51,4,1,0,0,0.00872093023255814,344
60,28,32,5,1,0,0,0,127
358,208,150,8,1,0,0,0,414
15,12,3,4,0,0,0,0,73
2,2,0,2,1,0,0,0,109
282,162,120,5,1,0,0,0,324
15,5,10,2,1,0,0,0,116
31,26,5,6,1,0,0,0,84
257,160,97,2,41,0,0,0,302
24,23,1,2,41,0,0,0,63
862,548,314,5,1,0,0,0,854
20,14,6,6,1,0,0,0,133
0,0,0,1,1,0,0,0,211
64,43,21,2,1,0,0,0,161
14,12,2,2,29,2,0,0,794
20,20,0,16,25,16,0,0,8941
5,5,0,1,9,0,0,0,1023
1,1,0,1,31,0,0,0,0
1,1,0,1,31,0,0,0,0
1,1,0,1,31,0,0,0,0
87,85,2,2,39,0,0,0.00263852242744063,379
3,3,0,1,41,0,0,0,88
21,21,0,1,41,0,0,0.00351493848857645,569
12,6,6,2,39,0,0,0,417
4,3,1,1,49,1,0,0,761
8,6,2,2,28,0,0,0,456
2,2,0,1,41,0,0,0.00126742712294043,789
80,64,16,5,41,2,0,0.000319590923617769,3129
91,89,2,1,39,0,0,0.00207900207900208,962
6,6,0,2,39,0,0,0,714
8,7,1,2,39,0,0,0,291
66,66,0,2,39,0,0,0,10668
3,3,0,2,39,0,0,0,721
12,12,0,2,39,0,0,0,785
19,1,18,6,35,0,0,0,337
531,432,99,17,7,7,0,0.00214438884917798,2798
4,4,0,1,80,0,0,0,118
24,13,11,5,6,4,0,0.00104384133611691,958
84,38,46,2,60,1,0,0.00478468899521531,209
5,3,2,2,60,1,0,0,79
0,0,0,1,74,0,0,0,0
215,213,2,3,13,2,0,0.00111482720178372,897
72,33,39,4,67,1,0,0,1341
21,11,10,1,82,0,0,0,334
94,19,75,1,74,0,0,0.00127713920817369,783
32,2,30,1,74,0,0,0,119
4,2,2,1,60,1,0,0,787
4,2,2,1,60,1,0,0,881
8,4,4,1,33,0,0,0,150
8,4,4,1,60,1,0,0.00138121546961326,724
10,5,5,2,33,0,0,0,220
13,5,8,1,77,0,0,0,434
2,1,1,1,74,0,0,0,575
10,3,7,2,60,1,0,0.00279329608938547,358
19,9,10,2,77,0,0,0,549
62,32,30,3,77,0,0,0,184
3,1,2,2,77,0,0,0,750
3,2,1,1,8,0,0,0,873
1,0,1,1,77,0,0,0,460
50,31,19,8,13,2,0,0,367
25,6,19,7,13,0,0,0.00133511348464619,749
5,4,1,2,11,1,0,0,192
1,1,0,1,22,0,0,0.00265957446808511,376
1,1,0,1,11,0,0,0,849
25,23,2,2,34,0,0,0.000728862973760933,1372
6,3,3,1,53,1,0,0,737
32,31,1,3,21,1,0,0,1163
110,67,43,15,3,6,0,0,430
22,6,16,7,5,0,0,0.00143884892086331,695
0,0,0,1,84,0,0,0,0
91,9,82,4,5,0,0,0.00313234142521535,1277
55,48,7,4,7,3,0,0,338
14,8,6,3,5,1,0,0,274
10,4,6,3,5,1,0,0,178
20,13,7,3,5,1,0,0,280
5,3,2,2,5,0,0,0,184
20,14,6,3,5,1,0,0,609
15,10,5,2,5,0,0,0,396
45,41,4,7,5,3,0,0.00564971751412429,177
65,26,39,17,4,3,0,0,745
5,4,1,2,39,0,0,0,376
178,143,35,15,0,4,0,0.00237247924080664,843
20,8,12,4,18,0,0,0.00204498977505112,489
105,55,50,12,0,7,0,0,727
10,5,5,1,45,1,0,0.00103305785123967,968
32,21,11,3,5,1,0,0.00280504908835905,1426
16,11,5,3,5,0,0,0,147
14,9,5,2,5,1,0,0,205
10,5,5,3,5,1,0,0,77
58,42,16,2,5,1,0,0,202
3,2,1,1,5,0,0,0,149
107,86,21,8,0,0,0,0,545
8,4,4,2,34,0,0,0.01,200
8,4,4,3,34,1,0,0.0176991150442478,113
28,15,13,3,5,0,0,0.0027063599458728,739
19,11,8,3,5,1,0,0,367
24,13,11,10,0,2,0,0,168
15,2,13,1,88,1,0,0,99
166,71,95,4,28,0,0,0,565
187,134,53,22,0,2,0,0,419
14,14,0,2,4,0,0,0,1575
2,1,1,1,5,0,0,0,223
12,7,5,2,5,0,0,0,250
2,1,1,1,34,0,0,0,104
2,1,1,1,34,0,0,0,45
4,1,3,2,34,0,0,0,124
161,108,53,9,5,5,0,0.00407925407925408,1716
58,39,19,3,5,0,0,0,214
20,16,4,3,39,1,0,0,238
40,12,28,5,18,1,0,0,202
41,30,11,7,30,2,0,0.00253807106598985,394
28,17,11,7,33,2,0,0.00669642857142857,448
132,76,56,6,5,2,0,0.00308641975308642,1620
27,13,14,9,33,1,0,0,1176
15,8,7,4,5,0,0,0.00277777777777778,2160
7,5,2,2,41,1,0,0,445
4,2,2,1,34,0,0,0,343
21,4,17,3,46,1,0,0,356
27,7,20,3,5,0,0,0,317
134,89,45,16,5,2,0,0.0025974025974026,770
2,1,1,1,4,0,0,0,0
50,33,17,3,4,0,0,0,0
0,0,0,1,4,0,0,0,0
0,0,0,1,18,0,0,0,0
0,0,0,1,4,0,0,0,0
70,56,14,5,18,0,0,0,0
0,0,0,1,0,0,0,0,0
0,0,0,1,84,0,0,0,0
46,37,9,4,33,0,0,0.0029940119760479,334
16,5,11,3,48,0,0,0,178
31,22,9,7,13,0,0,0.00443131462333826,677
45,34,11,5,28,3,0,0,604
40,31,9,5,6,1,0,0.00246305418719212,406
2,2,0,1,49,0,0,0,62
14,11,3,1,48,0,0,0,118
15,12,3,4,45,2,0,0,200
187,90,97,16,0,1,0,0.00262237762237762,1144
112,55,57,16,5,1,0,0.00177619893428064,563
10,9,1,2,18,0,0,0,1787
10,10,0,1,52,0,0,0,64
43,16,27,8,5,0,0,0.00471698113207547,212
2,1,1,1,39,0,0,0,36
408,188,220,19,12,3,0,0.00464396284829721,646
7,3,4,3,13,0,0,0,138
21,21,0,2,84,1,0,0,0
148,73,75,13,5,2,0,0.00546448087431694,549
17,4,13,2,47,0,0,0,225
22,11,11,5,19,3,0,0.00361663652802893,553
2,2,0,1,19,1,0,0.00813008130081301,246
2,1,1,1,53,0,0,0,285
11,5,6,3,13,0,0,0.00636942675159236,314
60,11,49,2,33,0,0,0.0117252931323283,597
78,17,61,4,33,1,0,0.00119047619047619,840
1,0,1,1,33,0,0,0,106
231,132,99,15,13,3,0,0.00377833753148615,794
14,10,4,3,47,2,0,0,67
20,0,20,1,33,0,0,0,213
4,2,2,2,62,2,0,0,132
50,49,1,3,69,2,0,0,228
10,3,7,2,82,0,0,0,73
41,23,18,9,30,2,0,0.00586510263929619,341
121,73,48,9,5,0,0,0,230
409,209,200,23,47,1,0,0.00484848484848485,825
2,1,1,1,70,0,0,0,44
1,1,0,1,47,0,0,0,84
52,27,25,6,57,0,0,0.00448430493273543,223
71,39,32,7,47,1,0,0,306
2,1,1,1,74,0,0,0,358
30,15,15,1,33,0,0,0,257
36,18,18,3,33,0,0,0,562
22,4,18,2,60,1,0,0.00217864923747277,459
14,6,8,1,60,1,0,0,169
37,17,20,4,35,0,0,0,570
31,18,13,3,77,0,0,0,511
7,3,4,3,77,0,0,0,524
3,2,1,1,7,0,0,0,1928
86,43,43,3,33,0,0,0,770
25,11,14,3,77,0,0,0,898
32,8,24,2,60,1,0,0.001,1000
20,9,11,1,60,1,0,0,227
59,29,30,2,77,0,0,0,543
4,2,2,2,82,0,0,0,277
3,2,1,1,7,0,0,0,916
4,2,2,1,74,0,0,0,370
24,5,19,2,60,1,0,0.00192678227360308,519
18,8,10,1,60,1,0,0,451
9,4,5,2,77,0,0,0,620
13,7,6,3,77,0,0,0,301
7,3,4,3,77,0,0,0,646
7,4,3,2,6,0,0,0,798
20,10,10,2,18,1,0,0.00588235294117647,510
2,2,0,1,27,0,0,0.00440528634361234,227
22,6,16,2,18,2,0,0.000395256916996047,2530
2,1,1,1,18,1,0,0.0158730158730159,63
27,13,14,3,18,1,0,0.00185528756957328,1617
4,2,2,2,27,0,0,0,949
15,8,7,1,34,0,0,0.00421348314606742,712
22,5,17,2,34,0,0,0.00191204588910134,523
53,17,36,7,16,1,0,0.00116754232340922,1713
0,0,0,3,4,0,0,0,0
0,0,0,3,4,0,0,0,0
0,0,0,3,4,0,0,0,0
0,0,0,3,4,0,0,0,0
31,31,0,1,71,0,0,0,49
148,74,74,2,40,0,1,0,416
84,52,32,2,40,0,1,0,377
136,95,41,8,40,0,3,0,185
108,56,52,2,78,0,2,0,641
2,1,1,1,76,1,0,0,177
172,100,72,2,78,0,1,0.00207900207900208,481
5,5,0,1,78,0,0,0,55
269,217,52,4,40,0,1,0.00630252100840336,476
2,2,0,1,78,0,0,0,228
136,68,68,1,78,0,1,0,299
4,3,1,1,40,0,0,0,107
403,289,114,5,71,1,2,0,162
99,28,71,4,71,0,2,0,59
0,0,0,1,79,0,1,0,0
115,73,42,5,71,0,2,0,295
0,0,0,1,79,0,1,0,0
64,20,44,2,78,0,2,0,102
2,1,1,2,71,0,0,0,0
0,0,0,1,71,0,0,0,0
88,85,3,3,78,0,2,0,429
27,26,1,3,78,0,2,0,235
216,215,1,2,71,0,0,0,0
83,7,76,4,71,1,1,0,350
34,28,6,4,71,1,1,0,501
23,16,7,3,40,0,1,0.00395256916996047,253
43,32,11,3,78,0,3,0,181
94,54,40,5,29,1,3,0,233
258,159,99,3,29,1,1,0,744
21,20,1,1,78,0,0,0,147
891,12,879,2,78,0,2,0,84
101,42,59,3,40,0,2,0,124
224,155,69,5,40,0,3,0,300
411,275,136,12,2,5,0,0.0099009900990099,606
10,9,1,3,2,1,0,0,53
365,212,153,9,34,2,3,0.00111234705228031,899
26,19,7,3,44,0,3,0,69
54,39,15,8,8,2,0,0.00359066427289048,557
7,7,0,2,43,0,0,0,562
15,13,2,1,27,0,0,0.00137174211248285,729
1,0,1,1,44,0,0,0,139
1,0,1,1,44,0,0,0,228
15,14,1,2,40,1,0,0.00343642611683849,291
0,0,0,1,44,0,0,0,0
0,0,0,1,44,0,0,0,0
4,4,0,2,40,0,0,0,3310
3,0,3,2,44,0,0,0,498
8,3,5,4,19,1,0,0.00169204737732657,2364
18,9,9,3,27,0,0,0,684
34,14,20,6,37,0,0,0,346
4,3,1,2,8,1,0,0,56
46,26,20,7,2,3,0,0,167
288,156,132,15,8,3,1,0.0019047619047619,525
34,16,18,2,66,1,1,0.00746268656716418,402
0,0,0,3,4,0,0,0,0
0,0,0,3,4,0,0,0,0
0,0,0,3,4,0,0,0,0
0,0,0,3,4,0,0,0,0
18,9,9,1,78,0,1,0,223
672,357,315,7,4,0,0,0,520
48,0,48,3,4,0,0,0,196
427,235,192,13,3,2,0,0.0068649885583524,437
56,12,44,2,59,0,0,0,189
6,3,3,1,42,1,0,0,492
2,2,0,1,42,0,0,0,151
24,7,17,3,33,0,0,0,430
128,79,49,10,16,3,0,0.00387221684414327,1033
6197,4374,1823,43,0,9,1,0.000606152447340506,6599
283,223,60,21,7,3,1,0.00147275405007364,679
403,201,202,15,6,7,0,0.00367917586460633,1359
4,4,0,1,3,1,0,0,122
494,394,100,14,0,2,0,0,765
12,8,4,3,7,2,0,0,70
110,76,34,2,70,0,0,0,170
835,368,467,18,27,6,0,0.002,1000
13,9,4,3,29,0,0,0,622
4,3,1,2,34,0,0,0,153
7,7,0,1,7,0,0,0,328
203,114,89,16,0,7,0,0.00161030595813205,1863
2,1,1,1,42,0,0,0.0212765957446809,47
235,139,96,9,12,2,0,0,698
8,3,5,1,59,0,0,0,101
0,0,0,3,4,0,0,0,0
0,0,0,3,4,0,0,0,0
0,0,0,3,4,0,0,0,0
0,0,0,3,4,0,0,0,0
0,0,0,3,4,0,0,0,110
629,92,537,4,4,0,0,0,75
0,0,0,3,4,0,0,0,45
253,142,111,4,4,0,0,0,939
9,9,0,3,4,0,0,0,102
5,5,0,1,40,1,0,0,234
85,39,46,9,3,6,0,0.000745156482861401,1342
5,3,2,3,3,2,0,0,88
76,34,42,5,16,2,0,0,794
18,7,11,7,4,0,0,0,596
6,3,3,1,74,0,0,0.00239808153477218,417
4,4,0,1,17,1,0,0,459
0,0,0,3,4,0,0,0,95
645,165,480,3,4,0,0,0,141
0,0,0,3,4,0,0,0,66
216,120,96,3,4,0,0,0.00479616306954436,417
198,114,84,3,4,0,0,0,244
44,19,25,6,4,2,0,0.00209643605870021,477
271,127,144,14,3,5,0,0.00171526586620926,583
4,4,0,1,3,1,0,0.00615384615384615,650
18,8,10,2,26,2,0,0,167
46,25,21,6,27,0,0,0,330
58,29,29,5,33,0,0,0,300
26,13,13,3,27,0,0,0,433
772,490,282,20,9,7,0,0.00322061191626409,621
39,16,23,3,22,1,0,0,94
70,39,31,3,34,2,0,0,243
85,18,67,4,34,1,0,0.000570450656018254,1753
257,165,92,14,3,9,0,0,963
25,25,0,1,17,1,0,0.000436109899694723,2293
14,8,6,2,34,0,0,0,1166
4,2,2,2,27,0,0,0,859
19,3,16,2,34,0,0,0,466
78,33,45,11,16,3,0,0.000851063829787234,1175
893,425,468,26,10,7,2,0.00100300902708124,997
25,16,9,2,37,0,0,0,129
0,0,0,1,60,0,0,0,0
0,0,0,1,60,0,0,0,0
0,0,0,1,60,0,0,0,0
0,0,0,1,60,0,0,0,0
0,0,0,1,60,0,0,0,0
0,0,0,1,60,0,0,0,0
0,0,0,1,60,0,0,0,0
0,0,0,1,60,0,0,0,0
0,0,0,1,60,0,0,0,0
0,0,0,1,60,0,0,0,0
0,0,0,1,60,0,0,0,0
0,0,0,1,60,0,0,0,0
0,0,0,1,60,0,0,0,0
0,0,0,1,60,0,0,0,0
0,0,0,1,60,0,0,0,0
4,0,4,3,54,0,0,0,0
0,0,0,1,60,0,0,0,0
0,0,0,1,60,0,0,0,0
0,0,0,1,60,0,0,0,0
0,0,0,1,60,0,0,0,0
0,0,0,1,60,0,0,0,0
0,0,0,1,60,0,0,0,0
0,0,0,1,60,0,0,0,0
0,0,0,1,60,0,0,0,0
10,5,5,3,54,1,0,0,0
0,0,0,1,60,0,0,0,0
32,10,22,5,6,1,0,0.000997008973080758,1003
2,2,0,1,6,0,0,0,664
8,4,4,1,34,0,0,0,370
18,8,10,1,60,1,0,0,283
150,89,61,2,77,0,0,0,2127
21,11,10,2,6,0,0,0,1308
1,0,1,1,6,0,0,0,408
6,3,3,1,74,0,0,0,719
9,5,4,1,74,0,0,0,269
12,0,12,1,74,0,0,0.00305810397553517,327
20,9,11,1,60,1,0,0,197
71,34,37,4,77,0,0,0,569
1,0,1,1,77,0,0,0,713
7,4,3,2,6,0,0,0,1155
97,7,90,2,74,0,0,0,680
72,29,43,1,28,1,0,0,425
6,3,3,1,74,0,0,0,1014
26,5,21,2,60,1,0,0,442
1,0,1,1,77,0,0,0,1433
353,171,182,11,57,0,0,0,1868
14,7,7,1,33,0,0,0,352
30,15,15,3,33,0,0,0,266
10,5,5,3,54,1,0,0,0
0,0,0,1,60,0,0,0,0
0,0,0,1,60,0,0,0,0
0,0,0,1,60,0,0,0,0
0,0,0,1,60,0,0,0,0
0,0,0,1,60,0,0,0,0
0,0,0,1,60,0,0,0,0
0,0,0,1,60,0,0,0,0
9,7,2,2,74,0,0,0,958
5,0,5,2,6,0,0,0,980
30,10,20,4,6,1,0,0.00224719101123596,445
21,10,11,1,60,1,0,0,199
160,73,87,11,57,0,0,0,967
7,4,3,2,6,0,0,0,1195
319,152,167,9,57,1,0,0,1835
3,2,1,1,85,0,0,0,2220
34,17,17,1,33,0,0,0,838
35,18,17,3,33,0,0,0,370
19,3,16,1,74,0,0,0,1602
20,10,10,3,33,0,0,0,1448
2,1,1,1,33,0,0,0,257
20,10,10,3,33,0,0,0,1446
2,1,1,1,33,0,0,0,249
20,10,10,3,33,0,0,0,1446
2,1,1,1,33,0,0,0,263
63,40,23,5,75,4,0,0,3208
33,33,0,2,39,1,0,0.000707213578500707,1414
73,0,73,1,74,0,0,0,2488
8,3,5,1,74,0,0,0,422
14,7,7,3,74,0,0,0,1224
8,4,4,1,46,1,0,0,4819
3,3,0,1,75,1,0,0,591
20,18,2,3,28,0,0,0,0
5,4,1,2,28,0,0,0,0
0,0,0,1,31,0,0,0,0
283,137,146,2,27,1,0,0,0
0,0,0,1,27,1,0,0,0
24,12,12,2,27,1,0,0,0
136,24,112,4,28,0,0,0,0
0,0,0,1,27,1,0,0,0
42,33,9,3,27,1,0,0,0
24,23,1,2,27,1,0,0,0
10,4,6,1,28,0,0,0,0
3987,9,3978,2,66,0,0,0,37
3,3,0,1,62,0,0,0.00103734439834025,964
100,77,23,1,57,0,0,0.00395256916996047,253
12,6,6,2,62,0,0,0.00943396226415094,106
16,7,9,3,62,0,0,0.005,200
43,33,10,3,39,0,0,0,4007
28,18,10,2,39,0,0,0,1226
17,10,7,1,39,0,0,0,840
435,230,205,3,39,0,0,0.000143864192202561,6951
838,423,415,2,39,0,0,0,2363
27,17,10,4,62,0,0,0.00458715596330275,218
1,0,1,1,66,0,0,0,1332
25,7,18,2,38,0,0,0.00133511348464619,749
6,3,3,1,59,0,0,0,592
467,401,66,2,38,0,1,0.0012070006035003,1657
11,11,0,1,38,0,0,0,172
67,46,21,8,34,1,0,0,527
20,13,7,2,35,0,0,0,228
15,9,6,4,5,4,0,0.00204918032786885,488
5,3,2,2,11,1,0,0,324
69,46,23,12,12,2,1,0.000605693519079346,1651
8,8,0,1,60,0,1,0,316
48,37,11,1,89,0,0,0,1461
118,65,53,1,89,0,0,0,126
85,28,57,10,35,0,0,0,1164
269,232,37,9,53,0,0,0.00156985871271586,637
15,12,3,4,53,0,0,0,81
4,2,2,1,59,0,0,0,162
348,258,90,3,58,0,0,0,823
6,5,1,2,57,0,0,0,96
620,365,255,8,38,2,0,0.000104832791697243,9539
12,7,5,2,75,0,0,0,112
16,11,5,2,5,2,0,0,107
32,14,18,4,55,1,0,0,1420
11390,5723,5667,2,39,0,0,0.000190512478567346,5249
11,10,1,3,38,0,0,0.00144927536231884,690
513,288,225,23,35,5,0,0.00092038656235619,2173
3,1,2,2,33,0,0,0,1671
11,8,3,2,13,2,0,0,193
871,589,282,27,34,2,0,0,1158
114,43,71,22,34,0,0,0,185
96,66,30,2,12,1,0,0,997
5,5,0,1,12,1,0,0,90
369,185,184,3,12,2,0,0,7436
9,5,4,3,12,2,0,0,1257
9,5,4,2,47,1,0,0,1104
8,4,4,2,77,2,0,0.000343642611683849,5820
44,32,12,6,14,4,0,0,1251
22,17,5,5,12,4,0,0,1439
11,3,8,1,18,0,0,0.00144927536231884,690
7,7,0,2,38,0,0,0,126
134,68,66,13,57,2,0,0,1795
213,65,148,24,12,3,0,0,3055
18,14,4,3,12,2,0,0,273
18,3,15,1,74,0,0,0,565
0,0,0,1,74,0,0,0,216
0,0,0,1,74,0,0,0,87
5333,2681,2652,4,39,0,0,0,5891
261,84,177,3,61,1,0,0.000472589792060492,2116
43,28,15,2,53,0,0,0,741
12,6,6,1,48,0,0,0,409
12,6,6,1,48,0,0,0,70
379,125,254,9,54,0,0,0,233
44,13,31,9,53,0,0,0,56
162,45,117,8,53,0,0,0,1652
24,16,8,3,53,0,0,0,59
371,92,279,8,53,0,0,0,574
33,33,0,3,53,0,0,0,106
10,8,2,2,23,2,0,0,1081
3,2,1,2,34,0,0,0.000633312222925902,1579
205,141,64,15,28,0,0,0,693
5,2,3,3,77,0,0,0,40
104,98,6,7,19,2,0,0,1394
3391,884,2507,13,35,0,0,0,358
282,14,268,7,77,0,0,0,39
174,2,172,4,82,0,0,0,0
30,22,8,6,12,5,0,0,368
6,6,0,1,62,0,0,0,71
960,629,331,19,24,2,1,0.00114810562571757,871
643,319,324,17,35,1,0,0.000541565123206066,3693
3,3,0,1,51,0,0,0,263
16,10,6,6,12,2,0,0,1237
180,110,70,17,11,11,0,0,1317
78,42,36,8,74,1,0,0.00177935943060498,562
38,22,16,3,55,1,0,0,823
2073,1024,1049,41,19,5,0,0.000259268861809697,3857
107,47,60,7,81,0,0,0,218
102,26,76,1,39,0,0,0,1137
36,18,18,14,0,0,0,0,53
1,0,1,1,66,0,0,0,582
7,6,1,2,9,0,0,0,217
44,38,6,2,49,0,0,0.000931098696461825,1074
0,0,0,1,9,0,0,0,0
0,0,0,1,9,0,0,0,0
0,0,0,1,9,0,0,0,0
0,0,0,1,9,0,0,0,0
0,0,0,1,9,0,0,0,0
2,1,1,2,9,0,0,0,0
0,0,0,1,9,0,0,0,0
4,0,4,1,54,0,0,0,159
3008,1519,1489,5,47,3,0,0,3669
8,7,1,1,11,0,0,0,1588
101,100,1,4,49,1,0,0.00218102508178844,917
6,6,0,2,88,1,0,0,113
31,29,2,3,87,1,0,0,1455
59,34,25,3,14,1,0,0.00282326369282891,1771
1,0,1,1,33,0,0,0,437
182,138,44,6,31,5,0,0.000965250965250965,1036
3,2,1,2,11,0,0,0.00133333333333333,750
16,14,2,2,79,0,0,0,180
13,7,6,3,34,0,0,0.000980392156862745,1020
21,11,10,2,10,1,0,0.00224719101123596,890
2234,1334,900,7,34,3,0,0.00035229874933944,5677
153,26,127,2,47,0,0,0.00478468899521531,209
34,17,17,3,34,3,0,0.00340136054421769,294
113,100,13,3,10,0,0,0.00151057401812689,662
7,7,0,1,84,0,0,0,52
132,88,44,6,55,1,1,0.000454959053685168,2198
0,0,0,1,38,0,0,0,0
1465,730,735,2,26,0,0,0,0
201,100,101,2,26,0,0,0,0
0,0,0,1,26,0,0,0,0
1765,887,878,4,9,0,0,0,0
1686,841,845,2,26,0,0,0,0
0,0,0,1,26,0,0,0,0
0,0,0,1,38,0,0,0,0
160,80,80,2,26,0,0,0,0
0,0,0,1,38,0,0,0,0
4,2,2,1,89,1,0,0,895
7,4,3,4,5,1,0,0.00056390977443609,5320
361,134,227,13,0,2,0,0.000684931506849315,2920
1,1,0,1,9,0,0,0,333
1,0,1,1,12,0,0,0,225
204,170,34,7,27,2,0,0.000376789751318764,2654
1,1,0,1,83,0,0,0,498
1,1,0,1,83,0,0,0,280
64,47,17,5,32,3,0,0,924
11,6,5,2,11,1,0,0,527
4,2,2,1,41,1,0,0,362
22,17,5,3,54,0,0,0,362
20,12,8,2,39,0,0,0,1370
2,1,1,1,10,0,0,0,1392
19,10,9,3,5,2,1,0,193
3,2,1,1,36,1,1,0,67
3,2,1,1,77,0,0,0,143
4,0,4,1,81,0,0,0.00662251655629139,151
21,15,6,2,32,1,0,0,193
11,7,4,4,13,2,0,0.00210084033613445,476
11,10,1,2,20,0,0,0.00386100386100386,259
357,107,250,7,2,3,1,0,225
8,8,0,1,20,0,0,0,169
13,12,1,2,77,0,0,0.00290697674418605,344
22,14,8,4,5,2,1,0.00363636363636364,825
2,2,0,1,80,1,0,0.00454545454545455,220
19,13,6,2,1,1,0,0.00280112044817927,357
31,26,5,3,18,0,0,0.00387596899224806,516
275,136,139,17,4,3,1,0.00612423447069116,1143
72,34,38,11,4,4,0,0.00453857791225416,661
0,0,0,1,12,1,0,0,0
0,0,0,1,12,1,0,0,0
43,2,41,1,36,1,1,0,228
20,12,8,3,21,1,0,0.00182481751824818,548
503,212,291,31,4,7,0,0.00420168067226891,1904
6,4,2,2,12,1,0,0.00576368876080692,347
4,4,0,2,2,1,1,0.00809716599190283,247
31,30,1,2,36,1,1,0,99
36,36,0,1,77,0,0,0,72
178,84,94,9,2,3,1,0.00395256916996047,759
11,6,5,2,7,1,1,0,274
5,5,0,2,20,0,0,0.00970873786407767,309
361,229,132,14,4,4,0,0.00119189511323004,839
15,10,5,3,74,0,0,0,88
7,7,0,1,73,1,0,0.00467289719626168,428
141,116,25,8,1,2,0,0.00327868852459016,305
149,100,49,13,3,5,0,0.00535331905781585,934
11,6,5,4,3,2,0,0,66
501,213,288,14,3,7,1,0.00469483568075117,426
80,60,20,3,5,2,1,0,195
76,44,32,9,18,3,0,0.00168067226890756,595
2,1,1,1,9,0,0,0.00165562913907285,604
8,3,5,1,74,0,0,0.00292397660818713,342
45,31,14,4,54,1,0,0.000678886625933469,1473
23,14,9,3,34,2,0,0.00371747211895911,269
36,25,11,3,40,0,0,0,634
10,7,3,1,54,1,0,0.00111234705228031,1798
86,43,43,4,54,2,0,0,3270
229,121,108,9,9,2,0,0,1163
24,12,12,3,9,0,0,0.0037593984962406,266
2,1,1,1,34,0,0,0,231
30,11,19,9,33,0,0,0,547
20,4,16,6,33,0,0,0.0043010752688172,465
4,0,4,1,34,0,0,0,211
206,103,103,2,60,0,0,0,320
14,7,7,2,33,0,0,0,277
16,6,10,3,33,0,0,0,358
28,14,14,2,33,0,0,0,824
1,0,1,1,34,0,0,0,188
55,25,30,6,33,0,0,0.00177935943060498,562
3,1,2,2,34,0,0,0,610
1,0,1,1,34,0,0,0,129
68,34,34,3,34,0,0,0,284
46,23,23,2,33,0,0,0,1155
13,11,2,9,9,0,0,0,1266
11,11,0,1,9,0,0,0,926
42,21,21,3,6,0,0,0.00121212121212121,825
30,15,15,1,33,0,0,0,347
88,44,44,3,33,0,0,0,675
6,5,1,2,20,2,0,0,201
57,43,14,4,20,3,0,0,956
125,80,45,5,5,1,0,0.00274223034734918,1094
4,4,0,1,47,1,0,0,423
33,21,12,1,13,1,0,0,263
12,6,6,1,75,0,0,0,1263
196,158,38,2,39,0,0,0,30414
20,10,10,6,33,0,0,0,248
24,14,10,2,39,0,0,0.000745156482861401,1342
2,1,1,1,52,1,0,0,678
2,2,0,1,6,0,0,0,1203
15,7,8,2,85,0,0,0,0
90,36,54,2,85,0,0,0,0
369,181,188,2,85,0,0,0,0
322,136,186,2,85,0,0,0,0
595,333,262,2,85,0,0,0,0
0,0,0,1,85,0,0,0,0
0,0,0,1,85,0,0,0,0
3,3,0,2,85,0,0,0,0
19,9,10,2,85,0,0,0,0
0,0,0,1,85,0,0,0,0
0,0,0,1,85,0,0,0,0
2,2,0,2,85,0,0,0,0
0,0,0,2,85,0,0,0,0
