CODECHURN,LOCADDED,LOCDELETED,REVISIONS,AGE,BUGFIXES,REFACTORINGS,ERROR_DENSITY,LOC
203,130,73,15,2,0,0,0,0
4,4,0,2,3,1,0,0,0
388,325,63,6,2,0,0,0,0
0,0,0,2,34,0,0,0,0
1387,763,624,52,0,5,0,0,0
117,61,56,3,13,0,0,0,0
0,0,0,1,31,0,0,0,18
0,0,0,1,27,0,0,0,0
342,301,41,10,0,0,0,0,0
68,40,28,8,2,2,0,0,0
31,31,0,4,0,1,0,0,0
6,2,4,2,20,0,0,0.0454545454545455,66
2,1,1,3,34,0,0,0,0
237,64,173,15,3,0,0,0,0
18,16,2,5,9,0,0,0,0
33,27,6,3,9,0,0,0,0
0,0,0,2,19,0,0,0,0
614,507,107,12,0,1,0,0,0
320,252,68,22,2,1,0,0,0
0,0,0,1,34,0,0,0,0
0,0,0,1,34,0,0,0,0
0,0,0,2,34,0,0,0,0
186,36,150,12,2,1,0,0,0
0,0,0,2,13,0,0,0,0
7,6,1,2,52,1,0,0,110
0,0,0,1,31,0,0,0,0
0,0,0,1,30,0,0,0,0
0,0,0,1,30,0,0,0,0
23,20,3,4,25,0,0,0,2241
4,4,0,2,3,0,0,0,1985
1157,1132,25,1,84,0,0,7.47999102401077e-05,13369
11,4,7,2,25,0,0,0,665
6,5,1,1,67,1,0,0,542
49,49,0,1,84,0,0,0.000691562932226833,1446
8,4,4,1,67,1,0,0,941
96,81,15,5,1,1,0,0,815
4,0,4,1,47,1,0,0,181
0,0,0,1,22,0,0,0,0
0,0,0,1,31,0,0,0,0
0,0,0,1,31,0,0,0,0
86,84,2,1,84,0,0,0.000801924619085806,1247
5,5,0,1,76,1,0,0,111
0,0,0,1,77,0,0,0,46
0,0,0,1,77,0,0,0,119
0,0,0,2,34,0,0,0,0
256,205,51,17,2,3,0,0,0
389,309,80,30,0,4,0,0,0
20,9,11,3,3,1,0,0,0
364,271,93,19,1,0,0,0,0
8,8,0,6,2,0,0,0,0
109,101,8,5,0,1,0,0,0
4,4,0,5,2,0,0,0,0
2,1,1,2,2,0,0,0,0
0,0,0,1,34,0,0,0,0
0,0,0,1,34,0,0,0,0
213,108,105,1,38,0,0,0,287
0,0,0,1,23,0,0,0,314
139,132,7,3,9,1,0,0,283
23,19,4,2,66,0,0,0,1342
1,0,1,1,76,0,0,0,672
10,9,1,2,77,0,0,0,784
4,2,2,1,39,0,0,0,619
1,0,1,1,76,0,0,0,1146
1,0,1,1,76,0,0,0,890
1,0,1,1,64,0,0,0,1039
15,11,4,1,17,0,0,0,687
0,0,0,1,31,0,0,0,0
0,0,0,1,31,0,0,0,0
0,0,0,1,31,0,0,0,0
0,0,0,1,31,0,0,0,0
1,1,0,1,83,1,0,0,147
14,9,5,1,83,1,0,0,216
15,10,5,1,83,1,0,0,647
4,3,1,2,83,1,0,0,482
84,67,17,3,30,0,0,0,223
3,2,1,1,84,0,0,0,120
1,1,0,1,83,1,0,0,264
0,0,0,1,27,0,0,0,0
0,0,0,2,64,0,0,0,0
0,0,0,2,64,0,0,0,0
0,0,0,2,64,0,0,0,0
0,0,0,2,64,0,0,0,0
4,3,1,2,85,0,0,0,361
12,8,4,4,57,0,0,0,0
363,265,98,7,30,0,0,0,954
4,3,1,2,85,0,0,0,775
0,0,0,1,57,0,0,0,474
25,20,5,1,76,1,0,0,289
8,5,3,1,76,0,0,0,659
6,4,2,2,54,2,0,0,516
3,2,1,2,42,1,0,0,268
0,0,0,1,80,0,0,0,0
5,5,0,2,18,0,0,0,420
0,0,0,1,42,0,0,0,173
12,9,3,6,27,0,0,0.00131233595800525,762
0,0,0,1,42,0,0,0,213
0,0,0,1,42,0,0,0,392
0,0,0,1,42,0,0,0,34
2,1,1,2,27,0,0,0.00393700787401575,254
2,1,1,2,27,0,0,0.00431034482758621,232
4,2,2,2,27,0,0,0,344
0,0,0,1,42,0,0,0,13
0,0,0,1,42,0,0,0,8
0,0,0,1,42,0,0,0,13
0,0,0,1,42,0,0,0,9
0,0,0,1,42,0,0,0,8
0,0,0,1,42,0,0,0,8
0,0,0,1,42,0,0,0,8
0,0,0,1,42,0,0,0,11
0,0,0,1,42,0,0,0,15
0,0,0,1,42,0,0,0,13
0,0,0,1,42,0,0,0,15
0,0,0,1,42,0,0,0,8
0,0,0,1,42,0,0,0,11
0,0,0,1,42,0,0,0,11
0,0,0,1,42,0,0,0,10
0,0,0,1,42,0,0,0,10
0,0,0,1,42,0,0,0,8
0,0,0,1,42,0,0,0,10
0,0,0,1,42,0,0,0,15
0,0,0,1,42,0,0,0,15
0,0,0,1,42,0,0,0,13
0,0,0,1,42,0,0,0,13
0,0,0,1,42,0,0,0,13
0,0,0,1,42,0,0,0,15
0,0,0,1,42,0,0,0,11
0,0,0,1,42,0,0,0,8
0,0,0,1,42,0,0,0,8
0,0,0,1,42,0,0,0,8
2,1,1,2,27,0,0,0.00389105058365759,257
0,0,0,1,42,0,0,0,15
0,0,0,1,42,0,0,0,13
0,0,0,1,42,0,0,0,23
0,0,0,1,42,0,0,0,23
0,0,0,1,42,0,0,0,16
0,0,0,1,42,0,0,0,12
0,0,0,1,42,0,0,0,16
0,0,0,1,42,0,0,0,16
0,0,0,1,42,0,0,0,11
0,0,0,1,42,0,0,0,18
0,0,0,1,42,0,0,0,23
0,0,0,1,42,0,0,0,15
0,0,0,1,42,0,0,0,18
0,0,0,1,42,0,0,0,11
0,0,0,1,42,0,0,0,14
0,0,0,1,42,0,0,0,14
0,0,0,1,42,0,0,0,13
0,0,0,1,42,0,0,0,13
0,0,0,1,42,0,0,0,11
0,0,0,1,42,0,0,0,13
0,0,0,1,42,0,0,0,18
0,0,0,1,42,0,0,0,18
0,0,0,1,42,0,0,0,16
0,0,0,1,42,0,0,0,16
0,0,0,1,42,0,0,0,15
0,0,0,1,42,0,0,0,16
0,0,0,1,42,0,0,0,12
0,0,0,1,42,0,0,0,11
0,0,0,1,42,0,0,0,13
0,0,0,1,42,0,0,0,11
2,1,1,2,27,0,0,0.00348432055749129,287
16,8,8,2,27,0,0,0.005,200
20,10,10,2,27,0,0,0.003125,320
24,12,12,2,27,0,0,0,591
16,8,8,2,27,0,0,0.00555555555555556,180
0,0,0,1,42,0,0,0,23
10,10,0,2,0,0,0,0,95
0,0,0,1,3,0,0,0,346
0,0,0,1,3,0,0,0,278
1399,681,718,12,22,0,0,0.00413223140495868,242
0,0,0,1,31,0,0,0,0
0,0,0,1,31,0,0,0,0
0,0,0,1,31,0,0,0,0
1,0,1,1,59,0,0,0,347
2,1,1,1,79,0,0,0,470
104,63,41,4,1,0,0,0.00257731958762887,388
1,0,1,1,59,0,0,0,375
16,9,7,4,76,1,0,0,711
9,0,9,1,89,0,0,0,267
83,58,25,5,1,1,0,0.00275482093663912,363
0,0,0,1,31,0,0,0,0
0,0,0,1,31,0,0,0,0
0,0,0,1,31,0,0,0,0
0,0,0,1,31,0,0,0,0
0,0,0,1,31,0,0,0,0
0,0,0,1,31,0,0,0,0
0,0,0,1,31,0,0,0,0
2,2,0,1,42,1,0,0,1919
4,2,2,1,13,0,0,0,187
5,3,2,2,85,0,0,0,289
5,3,2,2,85,0,0,0,289
5,3,2,2,85,0,0,0,289
13,8,5,5,27,0,0,0,109
2,2,0,1,39,0,0,0,88
2,2,0,1,39,0,0,0,84
2,1,1,1,39,0,0,0,98
4,2,2,1,86,0,0,0,62
3,2,1,2,39,0,0,0,129
3,2,1,1,39,0,0,0,79
1,0,1,1,76,0,0,0,171
4,3,1,3,38,1,0,0,379
18,15,3,4,36,1,0,0,218
0,0,0,1,41,0,0,0,205
4,2,2,2,41,0,0,0,194
18,15,3,4,36,1,0,0,213
19,16,3,4,36,1,0,0,182
0,0,0,1,41,0,0,0,188
2,2,0,2,41,0,0,0,177
4,2,2,2,41,0,0,0,136
4,2,2,2,41,0,0,0,179
4,2,2,2,41,0,0,0,352
0,0,0,1,41,0,0,0,280
2,2,0,2,41,0,0,0,163
27,14,13,1,11,0,0,0,194
6,4,2,1,11,0,0,0,74
20,10,10,1,86,0,0,0,389
18,9,9,1,86,0,0,0,378
31,21,10,2,84,0,0,0,303
30,15,15,1,86,0,0,0,1014
20,10,10,1,86,0,0,0,345
20,10,10,1,86,0,0,0,390
2,1,1,1,86,0,0,0,619
1,0,1,1,59,0,0,0,329
8,7,1,1,61,0,0,0,517
1,0,1,1,59,0,0,0,276
0,0,0,1,88,0,0,0,242
1,0,1,1,59,0,0,0,160
6,1,5,2,7,2,0,0,232
103,79,24,3,51,0,0,0,259
0,0,0,1,87,0,0,0,364
6,3,3,1,19,0,0,0,212
52,40,12,2,18,0,0,0,231
6,3,3,2,19,1,0,0,231
6,3,3,2,76,0,0,0.000267809319764328,3734
4,2,2,2,24,2,0,0,92
2,1,1,1,79,0,0,0,408
2,0,2,1,59,0,0,0,205
2,0,2,1,59,0,0,0,299
2,0,2,1,59,0,0,0,316
1,0,1,1,59,0,0,0,434
1,0,1,1,59,0,0,0,98
85,68,17,2,10,0,0,0,350
2,0,2,1,59,0,0,0,325
34,33,1,2,30,0,0,0,354
16,9,7,3,76,0,0,0,297
5,5,0,1,44,0,0,0,237
5,5,0,1,44,0,0,0,176
6,6,0,1,44,0,0,0,158
5,5,0,1,44,0,0,0,126
0,0,0,1,37,0,0,0,127
1,0,1,1,59,0,0,0,223
64,56,8,4,18,0,0,0,234
2,0,2,2,66,0,0,0,259
2,0,2,1,76,0,0,0,255
35,30,5,2,73,0,0,0,116
60,48,12,1,73,0,0,0,188
3,3,0,1,11,0,0,0,161
0,0,0,1,69,0,0,0,215
3,2,1,1,84,0,0,0,333
0,0,0,1,31,0,0,0,0
0,0,0,1,31,0,0,0,0
0,0,0,1,31,0,0,0,0
0,0,0,1,31,0,0,0,0
0,0,0,1,31,0,0,0,0
0,0,0,1,31,0,0,0,0
0,0,0,1,31,0,0,0,0
0,0,0,1,31,0,0,0,0
0,0,0,1,31,0,0,0,0
0,0,0,1,31,0,0,0,0
0,0,0,1,31,0,0,0,0
0,0,0,1,31,0,0,0,0
0,0,0,1,31,0,0,0,0
0,0,0,1,31,0,0,0,0
0,0,0,1,31,0,0,0,0
0,0,0,1,31,0,0,0,0
1,0,1,1,76,0,0,0,400
31,12,19,4,23,1,0,0,295
14,11,3,2,61,0,0,0,787
78,54,24,2,51,0,0,0,632
32,29,3,2,81,0,0,0,313
25,19,6,3,30,2,0,0,1195
34,31,3,2,77,0,0,0,421
13,3,10,1,23,1,0,0,195
10,10,0,1,66,0,0,0,343
51,34,17,4,20,1,0,0,267
4,4,0,1,81,0,0,0,490
2,1,1,1,48,0,0,0,396
0,0,0,1,30,0,0,0,0
0,0,0,1,30,0,0,0,0
0,0,0,1,30,0,0,0,0
4,3,1,3,10,0,0,0,187
35,3,32,3,47,1,0,0,169
288,108,180,18,42,3,0,0,483
106,1,105,3,85,1,0,0,0
166,103,63,6,18,3,0,0,161
8,6,2,1,85,0,0,0,137
83,59,24,1,85,0,0,0,246
103,88,15,1,85,0,0,0,246
0,0,0,1,17,0,0,0,0
0,0,0,1,65,0,0,0,0
28,14,14,2,37,0,0,0,1205
1153,789,364,18,26,3,0,0.000737463126843658,1356
150,65,85,9,52,1,0,0,941
34,26,8,2,51,0,0,0,0
0,0,0,1,51,0,0,0,0
199,107,92,16,51,3,0,0,0
100,78,22,3,51,1,0,0,0
3,0,3,2,51,1,0,0,0
1334,765,569,17,37,2,0,0.00160513643659711,1246
12,7,5,5,39,0,0,0,139
36,32,4,4,25,1,0,0,92
47,32,15,8,34,0,0,0.00118203309692671,846
54,15,39,4,34,1,0,0,159
209,0,209,3,58,0,0,0,128
16,3,13,2,63,1,0,0,19
747,452,295,13,0,0,2,0.0024390243902439,410
141,105,36,9,51,1,0,0,137
66,20,46,6,39,0,0,0,316
23,10,13,4,58,1,0,0,88
376,113,263,16,34,1,0,0,221
274,76,198,20,34,1,0,0,154
952,578,374,19,37,3,1,0.00288600288600289,693
88,64,24,10,51,1,0,0.0101010101010101,99
2,1,1,2,58,0,0,0.0178571428571429,56
4,2,2,2,39,0,0,0,37
63,51,12,3,56,0,1,0,90
7,4,3,3,56,0,0,0,96
8,5,3,2,58,1,0,0,29
56,45,11,2,56,0,0,0.00561797752808989,178
3,2,1,1,58,0,0,0,48
60,3,57,3,56,0,0,0,352
2,1,1,1,82,1,0,0,57
29,10,19,3,39,0,0,0,265
13,6,7,3,39,1,0,0,89
640,334,306,9,56,0,1,0,541
184,127,57,10,51,1,0,0,184
10,4,6,3,37,0,0,0,35
44,22,22,2,38,1,0,0,410
20,17,3,3,19,2,0,0,190
687,449,238,19,6,4,0,0.000784313725490196,1275
77,57,20,8,9,0,0,0,214
83,52,31,9,34,2,0,0.0082815734989648,483
28,23,5,3,34,0,0,0.0198019801980198,202
29,21,8,4,62,1,0,0.0113960113960114,351
4,2,2,2,62,0,0,0.0263157894736842,76
0,0,0,1,34,0,0,0,0
0,0,0,1,34,0,0,0,0
0,0,0,1,34,0,0,0,0
45,34,11,3,54,2,0,0.0116959064327485,342
87,53,34,6,17,1,0,0.00318471337579618,942
42,21,21,3,35,0,0,0.00113122171945701,884
38,19,19,3,74,0,0,0.00193798449612403,516
11,5,6,1,66,0,0,0.00680272108843537,147
8,1,7,1,34,0,0,0,179
92,56,36,6,17,1,0,0.0025062656641604,798
22,11,11,2,53,0,0,0.00884955752212389,339
45,12,33,4,3,0,0,0.00424628450106157,471
28,10,18,3,52,0,0,0.00923076923076923,325
64,40,24,8,34,2,0,0.0143266475644699,349
83,48,35,7,34,0,0,0.00611620795107034,327
4,3,1,2,34,0,0,0.00434782608695652,230
40,10,30,1,19,0,0,0.00617283950617284,162
45,12,33,4,3,0,0,0.00342465753424658,292
50,36,14,5,66,0,0,0.00425531914893617,235
44,12,32,4,3,0,0,0.00479616306954436,417
33,5,28,3,3,0,0,0.0050125313283208,399
45,24,21,6,34,1,0,0.00466200466200466,429
0,0,0,1,34,0,0,0,0
1,0,1,1,66,0,0,0.0108303249097473,277
1,1,0,1,54,0,0,0,94
38,10,28,1,19,0,0,0.0102040816326531,196
37,13,24,2,3,1,0,0,118
37,34,3,3,3,1,0,0,193
51,33,18,5,42,0,0,0.00366300366300366,273
11,7,4,3,62,0,0,0.0087719298245614,228
14,10,4,2,62,0,0,0,2258
4,2,2,2,62,0,0,0,253
14,6,8,2,3,1,0,0,460
14,9,5,1,62,0,0,0,328
12,7,5,3,62,0,0,0,210
47,8,39,4,34,0,0,0.00763358778625954,131
18,9,9,4,62,0,0,0.00816326530612245,245
6,3,3,2,62,0,0,0,217
15,12,3,5,62,0,0,0.00301204819277108,332
0,0,0,1,48,0,0,0,0
0,0,0,1,48,0,0,0,0
0,0,0,1,48,0,0,0,0
0,0,0,1,48,0,0,0,0
0,0,0,1,48,0,0,0,0
0,0,0,1,48,0,0,0,0
0,0,0,1,48,0,0,0,0
0,0,0,1,48,0,0,0,0
0,0,0,1,48,0,0,0,0
0,0,0,1,48,0,0,0,0
0,0,0,1,48,0,0,0,0
0,0,0,1,48,0,0,0,0
0,0,0,1,13,0,0,0,47
0,0,0,1,48,0,0,0,63
4,2,2,3,13,0,0,0,54
382,328,54,12,13,3,0,0.000625390869293308,1599
30,28,2,8,13,0,0,0,229
4,2,2,3,13,0,0,0,107
0,0,0,1,48,0,0,0,360
0,0,0,1,48,0,0,0,109
0,0,0,1,48,0,0,0,298
28,21,7,4,13,1,0,0,383
12,5,7,5,13,1,0,0,106
34,17,17,2,13,0,0,0,469
4,2,2,3,13,0,0,0,73
0,0,0,1,48,0,0,0,132
4,2,2,3,13,0,0,0,64
912,685,227,13,9,3,1,0.0014903129657228,671
27,15,12,7,10,1,0,0,66
28,18,10,3,16,1,0,0.00522875816993464,765
8,5,3,4,13,0,0,0.0065359477124183,153
4,2,2,3,13,0,0,0.0120481927710843,83
6,3,3,2,32,0,0,0.00261096605744125,383
0,0,0,1,48,0,0,0,72
8,3,5,3,13,0,0,0.00680272108843537,147
44,19,25,2,25,1,0,0,69
11,1,10,2,25,1,0,0,47
7,4,3,3,13,0,0,0,408
4,2,2,3,13,0,0,0,96
0,0,0,1,48,0,0,0,192
4,2,2,3,13,0,0,0,102
186,130,56,10,11,1,0,0.00202020202020202,495
11,9,2,5,11,0,0,0,87
0,0,0,2,25,0,0,0,0
0,0,0,2,25,0,0,0,0
21,17,4,4,13,0,0,0,431
4,2,2,3,13,0,0,0,95
0,0,0,1,2,0,0,0,0
0,0,0,1,2,0,0,0,0
76,57,19,9,13,0,0,0.0087719298245614,228
32,23,9,10,13,1,0,0.00591715976331361,169
3258,2360,898,26,13,5,0,0.00242718446601942,2060
0,0,0,1,48,0,0,0,72
4,2,2,3,13,0,0,0,75
4,2,2,2,13,0,0,0,239
4,2,2,3,13,0,0,0,91
4,2,2,3,13,0,0,0.0119047619047619,84
393,333,60,15,13,2,0,0.00402298850574713,1740
33,31,2,3,17,0,0,0,251
60,56,4,6,13,2,0,0,325
0,0,0,1,48,0,0,0,0
0,0,0,1,48,0,0,0,0
0,0,0,1,48,0,0,0,0
0,0,0,1,48,0,0,0,0
0,0,0,1,48,0,0,0,0
0,0,0,1,48,0,0,0,0
0,0,0,1,48,0,0,0,0
0,0,0,2,13,0,0,0,0
8,7,1,3,52,1,0,0,84
4,2,2,2,52,1,0,0,72
0,0,0,1,53,0,0,0,83
0,0,0,1,53,0,0,0,76
0,0,0,1,53,0,0,0,123
0,0,0,1,53,0,0,0,188
8,6,2,2,52,0,0,0,99
87,74,13,5,42,1,0,0,122
0,0,0,1,42,1,0,0,81
2,1,1,2,42,1,0,0,72
82,45,37,3,42,1,0,0,113
2,1,1,2,42,1,0,0,166
0,0,0,2,42,0,0,0,0
127,77,50,5,18,0,0,0.00451467268623025,443
0,0,0,1,52,0,0,0,128
0,0,0,1,52,0,0,0,92
1,1,0,1,54,0,0,0.00347222222222222,288
3894,2182,1712,8,33,3,0,0.000935453695042095,1069
111,37,74,3,62,0,0,0.00952380952380952,105
4,3,1,1,67,0,0,0.00462962962962963,216
31,20,11,4,7,0,0,0.00253807106598985,394
11,8,3,4,40,0,0,0.00200400801603206,499
0,0,0,1,67,0,0,0,0
2,1,1,1,54,0,0,0.00314465408805031,318
2,1,1,1,54,0,0,0.00311526479750779,321
8,6,2,2,33,0,0,0.00170357751277683,587
1,0,1,1,66,0,0,0.00520833333333333,192
36,32,4,2,54,0,0,0,169
9,8,1,2,2,0,0,0.000566893424036281,1764
7,4,3,2,3,1,0,0.00311526479750779,321
0,0,0,1,87,0,0,0,0
0,0,0,1,87,0,0,0,0
0,0,0,1,87,0,0,0,0
0,0,0,2,7,0,0,0,0
0,0,0,2,7,0,0,0,0
13,2,11,3,18,0,0,0,0
0,0,0,2,18,0,0,0,0
0,0,0,1,18,0,0,0,65
0,0,0,1,18,0,0,0,16
51,50,1,2,53,0,0,0,1097
10,10,0,2,53,0,0,0,278
104,67,37,5,53,2,0,0,704
0,0,0,1,53,0,0,0,0
0,0,0,1,53,0,0,0,0
3199,1671,1528,29,27,5,0,0.000272034820457019,3676
51,47,4,5,62,1,0,0,386
7,6,1,2,85,0,0,0,207
1,1,0,1,85,0,0,0,188
15,15,0,2,54,0,0,0,297
5,5,0,2,54,0,0,0,142
5,3,2,2,75,0,0,0,1369
48,27,21,10,34,5,0,0,559
15,7,8,3,53,2,0,0,267
1,1,0,1,53,0,0,0,82
64,38,26,3,80,2,0,0.000999666777740753,3001
107,91,16,6,0,2,0,0,1350
517,391,126,14,53,1,0,0.001318391562294,1517
125,112,13,11,53,1,0,0.00103412616339193,967
1,0,1,1,60,0,0,0,165
18,16,2,4,88,1,0,0,141
72,49,23,5,19,1,0,0,726
278,191,87,8,19,2,0,0,810
90,74,16,4,51,0,0,0,305
32,20,12,1,84,0,0,0,328
138,104,34,11,13,2,0,0.00451127819548872,665
4,3,1,2,13,0,0,0.0105263157894737,95
412,276,136,16,17,4,0,0.00808314087759815,866
56,44,12,4,27,1,0,0,262
0,0,0,1,31,0,0,0,0
476,125,351,9,17,1,0,0.00159489633173844,627
67,18,49,6,17,2,0,0.0028328611898017,353
6,2,4,2,42,1,0,0,0
0,0,0,1,42,0,0,0,0
41,12,29,2,53,0,0,0,307
10,8,2,2,52,0,0,0,80
15,3,12,4,27,1,0,0.008,125
93,93,0,3,42,0,0,0.00578034682080925,173
0,0,0,1,42,0,0,0.00378787878787879,264
68,38,30,4,34,0,0,0.00282885431400283,707
0,0,0,1,32,0,0,0,0
221,128,93,10,10,0,0,0.00216919739696312,461
545,194,351,8,27,0,1,0,341
207,156,51,4,21,1,0,0.00509337860780985,589
236,185,51,10,22,1,0,0.00363636363636364,275
151,67,84,8,10,0,0,0,175
7,7,0,2,10,0,0,0.00362976406533575,551
0,0,0,1,22,0,0,0,69
0,0,0,1,4,0,0,0,0
164,96,68,12,10,1,0,0.00124300807955252,1609
2,1,1,1,13,0,0,0.0142857142857143,70
0,0,0,1,4,0,0,0,0
0,0,0,1,4,0,0,0,0
46,31,15,7,17,1,0,0.00315457413249211,317
1,0,1,1,53,0,0,0,318
0,0,0,1,31,0,0,0,0
0,0,0,1,31,0,0,0,0
16,13,3,2,30,0,0,0,613
160,9,151,2,11,0,0,0,100
2,1,1,1,86,1,0,0,188
93,57,36,4,10,0,0,0,524
7,4,3,2,53,0,0,0.00574712643678161,174
42,17,25,5,17,1,0,0.00327868852459016,305
2,1,1,1,80,0,0,0,72
23,19,4,3,54,1,0,0,160
0,0,0,1,71,0,0,0,29
19,11,8,3,17,0,0,0.01,100
0,0,0,1,37,0,0,0.0175438596491228,57
18,1,17,2,19,1,0,0.0072992700729927,137
139,138,1,1,54,0,0,0.00543478260869565,184
23,18,5,3,54,1,0,0,228
0,0,0,1,52,0,0,0,0
0,0,0,1,52,0,0,0,0
0,0,0,1,52,0,0,0,0
8,4,4,4,27,0,0,0.0108695652173913,184
1,1,0,1,55,0,0,0,103
315,209,106,11,10,2,0,0.000593119810201661,1686
31,25,6,3,17,0,0,0.00826446280991736,121
4,4,0,2,52,0,0,0,0
98,68,30,2,52,0,0,0,150
34,14,20,2,46,0,0,0.00320512820512821,312
6,4,2,2,54,0,0,0.00431034482758621,232
166,94,72,7,16,2,0,0.00373134328358209,536
19,9,10,2,16,0,0,0.025974025974026,77
208,106,102,9,16,2,0,0.000598086124401914,1672
13,6,7,3,16,0,0,0.00826446280991736,121
0,0,0,1,82,0,0,0,0
0,0,0,1,82,0,0,0,0
0,0,0,1,82,0,0,0,0
0,0,0,1,82,0,0,0,0
4,2,2,1,54,0,0,0,197
0,0,0,1,54,0,0,0,17
9,5,4,3,44,1,0,0,377
4,2,2,2,19,1,0,0.00847457627118644,118
0,0,0,1,19,0,0,0.0181818181818182,55
2,1,1,1,54,0,0,0,92
11,6,5,5,17,1,0,0.00956937799043062,209
37,22,15,9,12,3,0,0.00478468899521531,209
72,19,53,6,19,1,0,0.0137931034482759,145
10,7,3,2,19,1,0,0.0119047619047619,168
104,56,48,6,27,0,0,0,2189
95,77,18,5,17,2,0,0.00429184549356223,466
0,0,0,1,19,1,0,0,10
119,75,44,14,11,5,0,0.00980392156862745,204
26,20,6,2,19,1,0,0,55
2,1,1,1,48,0,0,0,65
12,5,7,3,19,0,0,0.00291545189504373,343
70,36,34,3,27,0,0,0,1432
24,18,6,6,19,1,0,0.00436681222707424,229
46,34,12,3,18,0,0,0,101
224,157,67,8,17,1,0,0.00522648083623693,574
19,17,2,4,17,1,0,0.0099009900990099,101
3,1,2,2,24,0,0,0,145
5,1,4,2,19,1,0,0,0
17,6,11,4,27,1,0,0,810
14,8,6,2,75,0,0,0,1882
8,4,4,2,75,0,0,0.00581395348837209,172
4,2,2,2,75,0,0,0,173
57,36,21,3,60,0,0,0,269
54,27,27,2,27,1,0,0,631
4,2,2,2,75,0,0,0,356
2,1,1,1,37,0,0,0,843
9,5,4,2,75,0,0,0,146
27,14,13,2,75,0,0,0,245
3,1,2,2,24,0,0,0.00540540540540541,185
39,24,15,5,27,1,0,0.00714285714285714,140
226,154,72,6,27,1,0,0.00159744408945687,626
47,30,17,4,27,1,0,0,136
10,5,5,1,3,0,0,0,47
0,0,0,1,3,0,0,0,87
12,6,6,1,3,0,0,0.00662251655629139,151
6,3,3,1,3,0,0,0.0181818181818182,55
5,3,2,2,3,0,0,0.0072463768115942,138
1,0,1,1,68,0,0,0.0212765957446809,47
11,5,6,5,17,2,0,0.00843881856540084,237
45,32,13,8,3,2,0,0.0027027027027027,370
3,1,2,2,3,0,0,0,898
6,3,3,2,3,0,0,0,114
5,2,3,4,24,0,0,0,362
7,7,0,1,3,1,0,0,226
18,9,9,2,3,0,0,0,695
52,34,18,9,3,2,0,0.00634920634920635,315
4,2,2,1,3,0,0,0,80
115,75,40,11,17,1,0,0.00468933177022274,853
5,2,3,2,3,1,0,0,182
9,8,1,1,45,0,0,0,317
19,10,9,3,3,0,0,0.00495049504950495,404
8,5,3,2,3,0,0,0,227
1,1,0,1,55,0,0,0,231
29,18,11,3,3,0,0,0.00645161290322581,310
8,0,8,3,61,0,0,0.0326086956521739,92
220,94,126,11,3,3,0,0.00110987791342952,901
0,0,0,1,3,0,0,0.00434782608695652,230
0,0,0,1,3,0,0,0,0
43,20,23,3,3,1,0,0,0
2,1,1,1,68,0,0,0.00495049504950495,202
4,2,2,1,68,0,0,0,148
26,22,4,2,45,1,0,0,129
1,0,1,1,60,0,0,0,223
1,0,1,1,60,0,0,0,270
1,0,1,1,60,0,0,0,47
1,0,1,1,60,0,0,0,594
1,0,1,1,60,0,0,0,387
7,5,2,4,12,2,0,0.00636942675159236,157
12,8,4,3,27,2,0,0.00116009280742459,862
2,0,2,1,60,0,0,0.00257731958762887,388
1,1,0,1,56,0,0,0.00108342361863489,923
2,2,0,1,86,0,0,0,36
22,10,12,3,54,0,0,0.00346020761245675,289
223,16,207,4,27,0,0,0.00284900284900285,351
2,1,1,1,83,1,0,0,1433
1,0,1,1,60,0,0,0,215
1,0,1,1,60,0,0,0,180
4,2,2,1,27,0,0,0,513
22,11,11,1,62,0,0,0,208
8,4,4,1,27,0,0,0,218
12,10,2,1,45,1,0,0,180
2,1,1,2,54,0,0,0,84
24,11,13,5,17,1,0,0.00386100386100386,259
4,2,2,3,51,0,0,0.0033003300330033,303
249,240,9,2,19,0,0,0.0033112582781457,302
56,35,21,7,20,2,0,0.00239808153477218,417
15,11,4,3,17,1,0,0.00485436893203883,206
2,1,1,1,54,0,0,0.00495049504950495,202
2,0,2,1,35,0,0,0.00384615384615385,260
312,159,153,8,17,4,0,0.00345423143350604,579
18,9,9,2,53,0,0,0.00462962962962963,216
1,0,1,1,60,0,0,0,764
6,2,4,2,53,0,0,0.00302114803625378,331
4,2,2,2,35,1,0,0,617
4,2,2,1,27,0,0,0,1576
6,3,3,1,46,0,0,0,95
2,0,2,1,60,0,0,0.0277777777777778,36
2,0,2,1,60,0,0,0,129
3,3,0,1,46,0,0,0,1657
1,0,1,1,60,0,0,0.00432900432900433,231
38,11,27,5,19,2,0,0,293
5,2,3,2,27,0,0,0.00314465408805031,318
4,2,2,2,81,2,0,0,1521
1,0,1,1,60,0,0,0,1223
15,7,8,1,35,1,0,0.0043859649122807,228
1,0,1,1,60,0,0,0.00341296928327645,293
251,199,52,10,17,4,0,0.00111982082866741,893
4,4,0,1,48,1,0,0,52
89,7,82,5,3,1,0,0,98
63,13,50,5,16,1,0,0.0134529147982063,223
60,32,28,4,16,1,0,0.00892857142857143,224
3,0,3,1,48,1,0,0,37
200,51,149,5,16,3,0,0.00221729490022173,451
1,0,1,2,48,0,0,0,0
0,0,0,1,48,0,0,0,0
8,7,1,3,48,0,0,0,0
0,0,0,1,48,0,0,0,0
0,0,0,1,48,0,0,0,0
22,13,9,4,48,0,0,0,0
1,1,0,2,48,0,0,0,0
14,7,7,4,48,0,0,0,0
0,0,0,1,48,0,0,0,0
0,0,0,1,48,0,0,0,0
2,0,2,2,48,0,0,0,0
0,0,0,1,48,0,0,0,0
0,0,0,1,48,0,0,0,0
0,0,0,1,48,0,0,0,0
0,0,0,1,48,0,0,0,0
0,0,0,1,48,0,0,0,0
587,418,169,10,48,1,0,0,0
34,28,6,4,48,0,0,0,0
0,0,0,1,48,0,0,0,0
1,0,1,2,48,0,0,0,0
0,0,0,1,48,0,0,0,0
0,0,0,1,48,0,0,0,0
11,10,1,2,48,0,0,0,0
1,1,0,2,48,0,0,0,0
0,0,0,1,48,0,0,0,0
0,0,0,1,48,0,0,0,0
1,1,0,2,48,0,0,0,0
0,0,0,1,48,0,0,0,0
14,14,0,2,48,0,0,0,0
0,0,0,1,48,0,0,0,0
0,0,0,1,48,0,0,0,0
0,0,0,1,48,0,0,0,0
4,2,2,2,48,0,0,0,0
0,0,0,1,48,0,0,0,0
9,6,3,4,48,1,0,0,0
0,0,0,1,48,0,0,0,0
0,0,0,1,48,0,0,0,0
0,0,0,1,48,0,0,0,0
0,0,0,1,48,0,0,0,0
0,0,0,1,48,0,0,0,0
5,3,2,3,48,1,0,0,0
0,0,0,1,48,0,0,0,0
2,1,1,2,48,0,0,0,0
5,2,3,4,17,1,0,0.00847457627118644,118
1,0,1,1,81,0,0,0,58
71,24,47,13,17,3,0,0.0277777777777778,216
40,9,31,8,15,1,0,0.016260162601626,123
5,5,0,3,60,0,0,0,76
4,0,4,2,66,0,0,0.0155038759689922,129
16,16,0,1,4,0,0,0,126
4,4,0,1,4,0,0,0,64
102,85,17,8,4,2,0,0.0126582278481013,158
12,12,0,1,15,0,0,0.0204081632653061,49
201,111,90,16,10,1,0,0.013953488372093,215
131,85,46,15,10,3,0,0.0111111111111111,180
9,9,0,3,48,0,0,0,95
8,8,0,3,48,0,0,0,82
0,0,0,1,81,0,0,0,0
0,0,0,1,81,0,0,0,0
0,0,0,1,19,1,0,0,10
17,9,8,2,75,0,0,0,0
1286,682,604,32,3,5,0,0.00807381776239908,867
81,39,42,10,10,2,0,0.00425531914893617,235
146,113,33,8,10,4,0,0.00478468899521531,209
301,164,137,10,32,0,0,0,280
464,338,126,11,15,2,0,0.00573613766730402,523
80,60,20,10,15,0,0,0.00949367088607595,316
116,38,78,2,43,0,0,0,124
8,2,6,1,71,0,0,0,51
72,39,33,17,17,6,0,0.00955414012738853,314
15,7,8,5,13,3,0,0,78
550,338,212,41,3,10,0,0.0128700128700129,777
98,52,46,12,12,1,0,0.00689655172413793,145
72,55,17,9,4,2,0,0.0124223602484472,161
4,2,2,1,15,0,0,0,47
4,2,2,1,15,0,0,0,46
306,198,108,21,10,4,0,0.00627943485086342,637
191,66,125,5,15,0,0,0,461
59,34,25,14,12,0,0,0.00806451612903226,248
26,22,4,3,42,0,0,0,144
333,98,235,10,12,1,0,0,195
982,613,369,44,10,6,1,0.00671704450041982,1191
6,4,2,2,15,0,0,0.0384615384615385,78
14,8,6,3,17,0,0,0.00495049504950495,202
3,2,1,2,54,0,0,0,78
40,28,12,4,18,0,0,0,89
15,15,0,1,15,0,0,0.0307692307692308,65
8,4,4,4,13,0,0,0,142
145,73,72,7,42,0,0,0.00226500566251416,883
20,10,10,5,48,0,0,0,428
56,28,28,5,13,0,0,0.00636942675159236,314
9,4,5,3,25,0,0,0,403
0,0,0,1,2,0,0,0,0
3,1,2,2,54,0,0,0,0
57,2,55,4,13,1,0,0,48
14,5,9,7,62,2,0,0,0
82,50,32,9,12,1,0,0.00467289719626168,214
392,224,168,20,9,5,0,0.0352697095435685,482
52,44,8,6,15,2,0,0.0476190476190476,126
4,1,3,2,54,0,0,0,0
0,0,0,1,34,0,0,0.0158730158730159,126
0,0,0,1,34,0,0,0.0350877192982456,57
0,0,0,1,67,0,0,0,39
15,4,11,1,67,0,0,0.0126582278481013,79
347,215,132,8,30,2,0,0.0110192837465565,363
3,0,3,2,24,2,0,0,0
1,1,0,1,69,0,0,0,0
4,2,2,1,30,0,0,0.024390243902439,41
0,0,0,1,89,0,0,0,0
101,90,11,7,18,3,0,0.00581395348837209,344
24,24,0,2,19,2,0,0.0392156862745098,51
0,0,0,1,33,0,0,0,0
306,211,95,3,33,2,0,0,322
102,101,1,2,20,1,0,0.00523560209424084,191
34,2,32,4,35,1,0,0.0571428571428571,35
35,17,18,4,17,1,0,0,0
0,0,0,2,34,0,0,0,0
0,0,0,1,52,0,0,0,0
46,27,19,3,52,0,0,0,0
7,3,4,4,52,2,0,0,0
0,0,0,1,52,0,0,0,0
0,0,0,1,52,0,0,0,0
2,1,1,2,52,0,0,0,0
88,53,35,4,52,0,0,0,0
12,11,1,4,52,1,0,0,0
0,0,0,1,52,0,0,0,0
14,7,7,4,52,0,0,0,0
0,0,0,1,52,0,0,0,0
72,46,26,2,52,0,0,0,0
4,2,2,3,52,0,0,0,0
49,24,25,3,52,1,0,0,0
0,0,0,1,52,0,0,0,0
26,15,11,3,52,1,0,0,0
4,2,2,3,52,0,0,0,0
0,0,0,1,52,0,0,0,0
371,188,183,4,52,1,0,0,0
6,2,4,3,52,1,0,0,0
0,0,0,1,52,0,0,0,0
28,17,11,2,52,0,0,0,0
2,1,1,2,52,0,0,0,0
36,21,15,3,52,0,0,0,0
11,10,1,4,52,1,0,0,0
0,0,0,1,52,0,0,0,0
28,14,14,6,46,0,0,0,0
0,0,0,1,52,0,0,0,0
166,95,71,2,52,0,0,0,0
4,2,2,3,52,0,0,0,0
26,15,11,3,52,1,0,0,0
3,2,1,3,52,0,0,0,0
0,0,0,1,52,0,0,0,0
538,273,265,5,52,2,0,0,0
6,2,4,3,52,1,0,0,0
0,0,0,1,52,0,0,0,0
28,17,11,2,52,0,0,0,0
2,1,1,2,52,0,0,0,0
60,36,24,4,52,0,0,0,0
11,10,1,4,52,1,0,0,0
0,0,0,1,52,0,0,0,0
26,13,13,6,46,0,0,0,0
0,0,0,1,52,0,0,0,0
181,104,77,2,52,0,0,0,0
4,2,2,3,52,0,0,0,0
26,15,11,3,52,1,0,0,0
4,2,2,3,52,0,0,0,0
2,1,1,2,52,0,0,0,0
2,1,1,2,36,1,0,0,0
129,68,61,17,17,5,0,0,0
292,47,245,27,17,10,0,0,0
8,4,4,2,35,2,0,0,0
254,126,128,7,35,2,0,0,0
147,64,83,10,26,2,0,0,0
39,20,19,8,19,4,0,0,0
62,34,28,4,36,1,0,0,0
130,69,61,13,17,6,0,0,0
9,3,6,5,17,3,0,0,0
323,1,322,2,35,2,0,0,0
1032,263,769,17,17,3,0,0,0
6,3,3,3,20,1,0,0,0
28,14,14,4,36,1,0,0,0
82,42,40,4,35,2,0,0,0
62,31,31,5,27,2,0,0,0
12,6,6,2,36,1,0,0,0
28,14,14,4,36,1,0,0,0
32,16,16,4,36,1,0,0,0
88,29,59,5,34,1,0,0,0
60,42,18,5,36,2,0,0,0
19,9,10,5,36,1,0,0,0
90,49,41,7,17,3,0,0,0
338,174,164,11,27,2,0,0,0
226,114,112,7,35,3,0,0,0
2,1,1,2,36,1,0,0,0
129,68,61,17,17,5,0,0,0
319,50,269,27,17,10,0,0,0
259,134,125,10,35,4,0,0,0
238,119,119,7,35,3,0,0,0
189,96,93,10,26,3,0,0,0
33,17,16,7,19,3,0,0,0
72,39,33,5,36,2,0,0,0
124,69,55,14,17,7,0,0,0
13,5,8,7,17,4,0,0,0
380,1,379,2,35,2,0,0,0
1176,333,843,18,17,5,0,0,0
4,3,1,2,20,1,0,0,0
30,15,15,5,36,2,0,0,0
153,79,74,7,27,2,0,0,0
104,52,52,6,27,3,0,0,0
12,6,6,2,36,1,0,0,0
30,15,15,5,36,2,0,0,0
38,19,19,5,36,2,0,0,0
85,27,58,6,34,2,0,0,0
68,46,22,6,36,3,0,0,0
16,8,8,3,36,1,0,0,0
89,48,41,7,13,3,0,0,0
413,212,201,13,27,4,0,0,0
308,155,153,8,35,4,0,0,0
6,5,1,2,7,0,0,0,72
70,27,43,10,17,4,0,0.0186915887850467,107
178,123,55,22,17,5,0,0.00328947368421053,304
30,21,9,6,19,3,0,0.00378787878787879,264
2032,1504,528,32,2,11,0,0.00106997646051787,4673
20,15,5,2,71,0,0,0,75
31,0,31,2,19,0,0,0.00613496932515337,326
44,38,6,3,54,0,0,0,166
439,227,212,19,7,4,0,0.00597609561752988,502
15,8,7,6,7,1,0,0.0487804878048781,41
334,235,99,16,24,2,0,0.0035377358490566,848
758,389,369,22,7,4,0,0.00208333333333333,480
42,35,7,5,12,1,0,0.00888888888888889,225
289,170,119,12,12,2,0,0.00716845878136201,279
32,27,5,1,31,0,0,0,188
27,14,13,4,17,1,0,0.00882352941176471,340
2091,943,1148,23,13,4,0,0.00157977883096367,633
0,0,0,1,68,1,0,0,0
0,0,0,1,68,1,0,0,0
0,0,0,1,68,1,0,0,0
0,0,0,1,34,0,0,0.0036697247706422,545
0,0,0,1,34,0,0,0.027027027027027,37
107,60,47,6,6,3,0,0.00680272108843537,147
0,0,0,1,35,1,0,0,169
85,33,52,5,6,3,0,0.00574712643678161,174
0,0,0,1,35,1,0,0,177
0,0,0,1,36,0,0,0,14
10,3,7,5,14,0,0,0.0111111111111111,90
222,145,77,35,6,7,0,0.00378787878787879,264
104,43,61,9,3,4,0,0.00561797752808989,356
463,214,249,8,14,2,0,0.00210304942166141,951
70,38,32,3,14,0,0,0,49
363,155,208,6,11,3,0,0.008,250
26,18,8,2,36,1,0,0,127
48,40,8,1,72,1,0,0,0
253,141,112,12,5,4,0,0.00865800865800866,462
12,7,5,7,33,4,0,0.075,40
136,105,31,4,6,3,0,0,429
300,160,140,10,13,4,0,0.00307692307692308,650
26,12,14,6,14,2,0,0.0120481927710843,83
35,8,27,4,33,0,0,0,41
251,121,130,20,14,3,0,0,179
194,108,86,4,14,2,0,0.00427350427350427,234
14,3,11,3,33,0,0,0,17
33,10,23,3,33,0,0,0,36
38,12,26,3,33,0,0,0,40
115,56,59,5,11,2,0,0,52
40,10,30,4,33,0,0,0,41
0,0,0,1,36,0,0,0.0161290322580645,62
0,0,0,1,32,0,0,0,133
49,23,26,4,11,3,0,0.016304347826087,184
304,174,130,8,5,1,0,0.0087719298245614,570
182,69,113,10,15,3,0,0.000953288846520496,1049
121,95,26,15,7,1,0,0.0150753768844221,199
25,18,7,3,1,2,0,0.00536193029490617,373
9,8,1,1,79,0,0,0.010989010989011,91
396,223,173,44,2,9,0,0.0420168067226891,238
352,187,165,50,0,8,0,0.0238095238095238,420
73,42,31,6,7,3,0,0,185
23,13,10,4,1,1,0,0.0106382978723404,94
0,0,0,1,7,0,0,0.0638297872340425,47
1464,724,740,77,1,15,0,0.0103270223752151,1162
99,52,47,21,15,2,0,0.00934579439252336,107
18,16,2,5,21,1,0,0.0365853658536585,82
19,12,7,6,1,2,0,0.0153256704980843,261
8,6,2,2,1,2,0,0.0178571428571429,168
90,76,14,6,15,0,0,0.000887311446317658,3381
1144,678,466,47,7,14,0,0.0105882352941176,850
467,176,291,37,1,10,0,0.0099009900990099,303
92,61,31,12,0,3,0,0.010752688172043,93
2,1,1,4,7,2,0,0.0127388535031847,314
0,0,0,3,34,2,0,0.0202020202020202,99
1496,889,607,77,1,17,0,0.0133239831697055,1426
714,343,371,28,1,4,0,0.0130597014925373,536
651,268,383,20,1,7,0,0.00435729847494553,459
31,21,10,7,1,1,0,0,133
5,3,2,2,29,0,0,0,31
1196,929,267,35,1,7,0,0.0100401606425703,996
594,270,324,15,24,3,0,0.0285714285714286,70
100,78,22,7,0,2,0,0,388
15,14,1,3,46,1,0,0,54
271,225,46,6,17,2,0,0.0285714285714286,280
33,3,30,3,17,1,0,0.0606060606060606,33
0,0,0,1,58,0,0,0,0
0,0,0,1,58,0,0,0,0
187,66,121,7,1,3,0,0.0149253731343284,335
13,9,4,1,21,0,0,0.0298507462686567,67
429,277,152,12,7,4,0,0.0227272727272727,176
0,0,0,1,24,1,0,0.00847457627118644,118
0,0,0,1,24,1,0,0.0181818181818182,55
4,4,0,1,87,0,0,0,94
64,47,17,15,17,4,0,0.0115606936416185,346
30,19,11,8,19,1,0,0.0172413793103448,174
504,274,230,13,24,2,0,0.00843881856540084,237
0,0,0,1,17,0,0,0,70
0,0,0,1,17,0,0,0,40
10,4,6,3,17,1,0,0,106
7,6,1,1,18,1,0,0,203
9,7,2,2,18,1,0,0,243
84,15,69,3,21,2,0,0.00393700787401575,508
0,0,0,1,19,1,0,0,10
80,39,41,3,62,0,0,0.00199203187250996,1004
378,140,238,7,5,2,0,0,886
0,0,0,1,5,1,0,0,147
26,13,13,4,38,1,0,0.00529100529100529,189
26,26,0,1,87,0,0,0,137
4,4,0,1,87,0,0,0,43
93,71,22,14,17,5,0,0.0120967741935484,248
20,12,8,2,19,2,0,0,62
293,205,88,8,38,2,0,0.00279329608938547,1432
74,57,17,10,19,2,0,0.00763358778625954,262
14,12,2,1,46,0,0,0,113
3,1,2,2,54,1,0,0.00373134328358209,268
48,32,16,8,5,3,0,0.0078125,256
111,78,33,5,16,1,0,0.00598802395209581,334
2,1,1,2,54,0,0,0,104
41,29,12,4,18,0,0,0,90
599,347,252,10,17,2,0,0.00100704934541793,1986
9,5,4,2,80,1,0,0.0065359477124183,153
75,42,33,6,17,1,0,0.00353356890459364,283
14,10,4,3,17,1,0,0.0062111801242236,161
341,136,205,14,15,3,0,0.00191204588910134,523
38,18,20,4,16,2,0,0.0087719298245614,114
60,29,31,5,17,2,0,0.00215982721382289,463
4,2,2,1,17,1,0,0,162
171,120,51,13,16,3,0,0.00328947368421053,304
3,1,2,1,16,0,0,0.0175438596491228,57
10,5,5,6,24,2,0,0,0
20,10,10,4,24,2,0,0,0
9,5,4,1,34,1,0,0.000700280112044818,1428
3,2,1,1,34,1,0,0.00423728813559322,236
53,36,17,6,16,2,0,0.00689655172413793,290
37,21,16,9,19,1,0,0.00222222222222222,450
13,9,4,3,45,1,0,0.00261780104712042,382
3,1,2,2,54,0,0,0.00675675675675676,296
3,1,2,2,54,0,0,0.00393700787401575,254
30,12,18,5,44,1,0,0,240
4,2,2,1,27,0,0,0.008,125
8,2,6,4,54,0,0,0.0142857142857143,70
17,13,4,3,46,0,0,0,162
8,1,7,3,48,0,0,0.00395256916996047,253
6,0,6,2,49,0,0,0.0153846153846154,65
15,11,4,5,53,0,0,0,131
12,4,8,3,27,0,0,0.00546448087431694,183
1,0,1,1,66,0,0,0.0037593984962406,266
8,3,5,5,52,0,0,0.00806451612903226,248
104,65,39,10,17,3,0,0.00374531835205993,267
49,32,17,6,19,0,0,0.00854700854700855,117
13,11,2,4,54,0,0,0,198
69,49,20,10,27,2,0,0.00426439232409382,469
8,1,7,2,54,0,0,0,89
655,360,295,17,34,3,0,0.00112359550561798,890
146,98,48,6,34,1,0,0.00416666666666667,240
2,1,1,1,54,0,0,0,144
299,153,146,11,14,2,0,0.000911577028258888,1097
8,6,2,4,17,1,0,0.0050251256281407,199
4,2,2,2,37,0,0,0.00416666666666667,240
291,134,157,4,27,0,0,0,435
209,87,122,8,37,2,0,0.00404858299595142,247
16,10,6,5,18,0,0,0,204
84,51,33,7,19,0,0,0.0034965034965035,286
26,13,13,3,37,0,0,0.003584229390681,279
61,29,32,3,27,0,0,0.00558659217877095,179
56,33,23,8,27,2,0,0.004,250
17,9,8,4,54,0,0,0.00285714285714286,350
5,2,3,3,54,0,0,0.0118343195266272,169
7,3,4,3,27,0,0,0.00423728813559322,236
2,2,0,1,84,0,0,0,282
34,16,18,4,61,1,0,0.0072992700729927,137
3,0,3,1,66,0,0,0,277
16,13,3,2,61,0,0,0,395
21,21,0,3,34,2,0,0,366
355,285,70,8,34,2,0,0.000341180484476288,2931
42,26,16,3,30,1,0,0.00647249190938511,309
31,19,12,1,45,0,0,0,227
526,297,229,3,17,0,0,0,722
194,97,97,1,45,0,0,0,168
2,2,0,1,45,0,0,0,48
0,0,0,1,0,0,0,0,59
0,0,0,1,0,0,0,0,13
1,1,0,1,54,0,0,0.0131578947368421,76
424,334,90,10,17,5,0,0.00254129606099111,1574
15,8,7,2,37,1,0,0.00892857142857143,112
101,9,92,7,14,2,0,0,105
16,8,8,3,42,0,0,0.00318979266347687,627
147,54,93,15,34,1,0,0.00617283950617284,486
4,2,2,2,42,1,0,0.0266666666666667,75
26,17,9,2,18,0,0,0,45
45,19,26,6,17,1,0,0.00115874855156431,863
269,66,203,6,17,3,0,0.00242718446601942,824
6,2,4,3,17,1,0,0.0078125,128
2,1,1,1,84,0,0,0,68
30,18,12,3,17,1,0,0.00568181818181818,176
31,26,5,4,17,2,0,0.00699300699300699,143
0,0,0,1,54,0,0,0,0
230,62,168,4,54,0,0,0,0
131,67,64,14,19,0,0,0,188
8,6,2,1,52,0,0,0.0050251256281407,199
140,98,42,11,17,3,0,0.0113636363636364,352
42,34,8,9,37,2,0,0.00643776824034335,466
97,42,55,9,10,1,0,0.0106382978723404,188
41,33,8,4,54,0,0,0,0
45,1,44,3,54,0,0,0,0
99,40,59,9,16,5,0,0.00335570469798658,298
57,41,16,5,53,1,0,0.00201612903225806,496
128,57,71,21,17,1,0,0.00992555831265509,403
0,0,0,1,54,0,0,0,0
51,36,15,4,16,1,0,0.00826446280991736,121
26,3,23,5,16,0,0,0.00540540540540541,185
2,1,1,1,9,0,0,0.0121951219512195,82
71,39,32,6,3,3,0,0.0131578947368421,76
0,0,0,1,0,0,0,0,36
0,0,0,1,49,0,0,0.00491400491400491,407
24,24,0,4,12,2,0,0.00689655172413793,145
42,23,19,6,19,1,0,0,29
0,0,0,1,3,0,0,0.00775193798449612,129
0,0,0,1,3,0,0,0.0163934426229508,61
14,13,1,2,2,0,0,0,186
5,0,5,2,2,0,0,0.0108695652173913,92
0,0,0,1,3,0,0,0.0106382978723404,94
0,0,0,1,3,0,0,0.0112359550561798,89
0,0,0,2,2,0,0,0,0
76,42,34,4,2,0,0,0.0078740157480315,381
13,7,6,2,2,0,0,0.00869565217391304,115
0,0,0,1,3,0,0,0.00760456273764259,263
0,0,0,1,3,0,0,0.0363636363636364,55
0,0,0,1,3,0,0,0,10
805,607,198,9,3,1,0,0,0
38,27,11,8,3,0,0,0,0
0,0,0,2,3,0,0,0,0
0,0,0,2,3,0,0,0,0
34,17,17,3,3,0,0,0,0
12,6,6,4,3,0,0,0,0
181,70,111,15,3,6,0,0,0
58,16,42,5,3,0,0,0,0
929,165,764,26,3,6,0,0,0
73,27,46,9,3,2,0,0,0
113,12,101,5,3,0,0,0,0
627,326,301,28,3,5,0,0,0
53,44,9,9,3,0,0,0,0
449,135,314,14,3,1,0,0,0
6,3,3,3,3,0,0,0,0
0,0,0,2,3,0,0,0,0
30,30,0,3,3,0,0,0,0
0,0,0,2,3,0,0,0,0
30,12,18,2,2,0,0,0.00384615384615385,520
0,0,0,1,3,0,0,0,59
2,1,1,2,3,0,0,0,0
29,16,13,3,2,0,0,0.00721153846153846,416
0,0,0,1,3,0,0,0,46
2,1,1,2,3,0,0,0,0
2,1,1,2,3,0,0,0,0
2,1,1,3,2,0,0,0,0
2,1,1,2,3,0,0,0,0
2,1,1,2,3,0,0,0,0
2,1,1,2,3,0,0,0,0
2,1,1,2,3,0,0,0,0
2,1,1,2,3,0,0,0,0
2,1,1,3,2,0,0,0,0
2,1,1,2,3,0,0,0,0
2,1,1,2,3,0,0,0,0
63,36,27,6,0,0,0,0.00305810397553517,327
0,0,0,1,3,0,0,0,54
0,0,0,2,3,0,0,0,0
0,0,0,2,3,0,0,0,0
0,0,0,2,3,0,0,0,0
0,0,0,2,3,0,0,0,0
0,0,0,2,3,0,0,0,0
0,0,0,2,3,0,0,0,0
0,0,0,2,3,0,0,0,0
1058,442,616,28,15,4,0,0.00258175559380379,1162
78,29,49,5,15,1,0,0.0186915887850467,107
0,0,0,1,23,0,0,0.0147058823529412,136
0,0,0,1,23,0,0,0.024390243902439,41
32,32,0,2,16,0,0,0.00881057268722467,227
0,0,0,1,73,0,0,0.0126582278481013,79
0,0,0,2,65,0,0,0,0
0,0,0,2,65,0,0,0,0
108,44,64,6,20,1,0,0.00778210116731518,257
0,0,0,1,23,0,0,0.0114942528735632,87
2,1,1,3,18,1,0,0,0
0,0,0,1,65,0,0,0,0
0,0,0,1,65,0,0,0,0
0,0,0,1,65,0,0,0,0
0,0,0,1,65,0,0,0,0
0,0,0,1,65,0,0,0,0
72,46,26,9,19,2,0,0.00225733634311512,886
2,2,0,2,35,0,0,0.0141843971631206,141
2,1,1,2,47,0,0,0,682
0,0,0,1,51,0,0,0,11
620,399,221,11,23,3,1,0.00339750849377123,883
41,22,19,8,18,2,0,0.00662251655629139,151
13,9,4,4,18,1,0,0.025,40
613,328,285,16,15,4,0,0.00276243093922652,724
4,2,2,4,20,0,0,0,0
0,0,0,2,20,0,0,0,0
70,54,16,3,39,1,0,0.00203665987780041,491
10,8,2,2,39,1,0,0.00900900900900901,111
547,481,66,13,65,1,0,0,0
20,17,3,6,65,0,0,0,0
0,0,0,2,65,0,0,0,0
0,0,0,2,65,0,0,0,0
187,148,39,10,65,0,0,0,0
0,0,0,2,65,0,0,0,0
72,36,36,6,65,0,0,0,0
1,1,0,3,65,0,0,0,0
0,0,0,2,65,0,0,0,0
0,0,0,2,65,0,0,0,0
144,78,66,6,65,0,0,0,0
83,79,4,4,65,0,0,0,0
8,2,6,3,65,0,0,0,0
144,79,65,7,65,0,0,0,0
0,0,0,2,65,0,0,0,0
0,0,0,2,65,0,0,0,0
71,61,10,6,65,1,0,0,0
8,7,1,5,65,1,0,0,0
11,9,2,2,49,1,0,0,8
11,9,2,2,49,1,0,0,8
212,104,108,10,18,0,0,0,2644
4,3,1,2,70,0,0,0,216
6,3,3,3,37,0,0,0,375
801,397,404,25,5,4,0,0.00163800163800164,1221
78,30,48,6,14,0,0,0,383
12,8,4,2,15,0,0,0,48
153,108,45,8,14,4,1,0.00602409638554217,332
5,1,4,3,14,0,0,0.0196078431372549,51
25,4,21,4,19,1,0,0,0
0,0,0,1,42,0,0,0,0
11,8,3,4,42,0,0,0,0
0,0,0,1,42,0,0,0,0
0,0,0,1,42,0,0,0,0
0,0,0,1,42,0,0,0,0
14,7,7,4,42,0,0,0,0
14,7,7,4,42,0,0,0,0
143,72,71,10,2,5,0,0.00323624595469256,309
14,6,8,3,18,3,0,0.00943396226415094,106
33,4,29,3,18,2,0,0,212
11,2,9,4,18,2,0,0,0
9,5,4,3,2,0,0,0.00173913043478261,575
279,46,233,5,2,2,0,0,72
17,4,13,2,18,2,0,0,43
0,0,0,1,42,0,0,0,0
0,0,0,1,42,0,0,0,0
0,0,0,1,42,0,0,0,0
0,0,0,2,42,0,0,0,0
0,0,0,2,42,0,0,0,0
0,0,0,1,42,0,0,0,0
0,0,0,1,42,0,0,0,0
0,0,0,1,42,0,0,0,0
0,0,0,1,42,0,0,0,0
0,0,0,1,42,0,0,0,0
0,0,0,1,42,0,0,0,0
0,0,0,1,42,0,0,0,0
0,0,0,1,42,0,0,0,0
0,0,0,1,42,0,0,0,0
0,0,0,1,42,0,0,0,0
0,0,0,1,42,0,0,0,0
0,0,0,1,42,0,0,0,0
0,0,0,1,42,0,0,0,0
0,0,0,1,42,0,0,0,0
0,0,0,1,42,0,0,0,0
0,0,0,1,42,0,0,0,0
0,0,0,1,42,0,0,0,0
2,1,1,2,42,1,0,0,0
0,0,0,1,42,0,0,0,0
0,0,0,1,42,0,0,0,0
0,0,0,1,42,0,0,0,0
0,0,0,1,42,0,0,0,0
0,0,0,1,42,0,0,0,0
0,0,0,1,42,0,0,0,0
61,50,11,5,42,0,0,0,0
0,0,0,1,42,0,0,0,0
0,0,0,1,42,0,0,0,0
0,0,0,1,42,0,0,0,0
0,0,0,1,42,0,0,0,0
0,0,0,2,42,0,0,0,0
0,0,0,2,42,0,0,0,0
0,0,0,1,42,0,0,0,0
0,0,0,1,42,0,0,0,0
0,0,0,1,42,0,0,0,0
0,0,0,1,42,0,0,0,0
0,0,0,1,42,0,0,0,0
0,0,0,1,42,0,0,0,0
0,0,0,1,42,0,0,0,0
0,0,0,1,42,0,0,0,0
0,0,0,1,42,0,0,0,0
0,0,0,1,42,0,0,0,0
0,0,0,1,42,0,0,0,0
0,0,0,1,42,0,0,0,0
0,0,0,1,42,0,0,0,0
0,0,0,1,42,0,0,0,0
0,0,0,1,42,0,0,0,0
0,0,0,1,42,0,0,0,0
0,0,0,1,42,0,0,0,0
0,0,0,1,42,0,0,0,0
0,0,0,1,42,0,0,0,0
0,0,0,1,42,0,0,0,0
0,0,0,1,42,0,0,0,0
0,0,0,1,42,0,0,0,0
0,0,0,1,42,0,0,0,0
0,0,0,1,42,0,0,0,0
52,46,6,4,42,0,0,0,0
0,0,0,1,42,0,0,0,0
10,5,5,2,42,0,0,0,0
20,10,10,2,42,0,0,0,0
0,0,0,1,42,0,0,0,0
0,0,0,1,42,0,0,0,0
3,3,0,1,73,0,0,0,78
113,68,45,7,9,2,0,0.00241545893719807,828
11,5,6,3,17,1,0,0.00204918032786885,488
26,10,16,5,27,0,0,0.00272479564032698,367
2,1,1,1,54,0,0,0,487
551,380,171,1,55,0,0,0,455
72,40,32,6,9,3,0,0.00151057401812689,662
4,2,2,1,9,1,0,0.00961538461538462,104
87,47,40,5,9,1,0,0.00143472022955524,697
2,1,1,1,9,1,0,0.0147058823529412,68
77,48,29,6,9,3,0,0.00139082058414465,719
2,1,1,1,9,1,0,0.00847457627118644,118
35,17,18,6,27,1,0,0.00182149362477231,549
64,40,24,4,9,1,0,0.00162337662337662,616
3,2,1,1,9,1,0,0.012987012987013,77
40,20,20,3,9,2,0,0.0032258064516129,310
151,76,75,2,54,0,0,0,440
11,5,6,2,17,1,0,0.00636942675159236,157
105,61,44,6,9,1,0,0.00177935943060498,562
15,12,3,4,9,2,0,0.00332225913621262,301
0,0,0,1,73,0,0,0.00536193029490617,373
0,0,0,1,73,0,0,0.025,40
116,75,41,8,9,3,0,0.00216919739696312,461
29,25,4,3,18,1,0,0.0078125,128
170,74,96,6,11,2,0,0.00136612021857923,732
10,8,2,1,11,0,0,0,49
84,34,50,5,11,0,0,0,227
11,6,5,3,11,0,0,0,76
31,1,30,2,18,1,0,0,50
4,2,2,1,11,0,0,0,482
135,62,73,3,11,0,0,0,599
20,11,9,2,11,0,0,0,165
5,5,0,1,45,0,0,0,90
79,32,47,6,11,1,0,0.00239234449760766,418
11,2,9,1,11,0,0,0,76
0,0,0,1,11,0,0,0,0
0,0,0,1,11,0,0,0,0
13,13,0,1,43,0,0,0,321
16,16,0,1,43,0,0,0,79
3,0,3,1,48,1,0,0,106
52,27,25,4,12,1,0,0,583
65,44,21,11,16,1,0,0.00240963855421687,415
99,71,28,10,27,2,0,0.00659340659340659,455
310,252,58,22,18,6,0,0.0032599837000815,1227
83,39,44,10,12,2,0,0.00182315405651778,1097
2,1,1,1,12,1,0,0.0121951219512195,82
34,16,18,2,66,0,0,0,690
2,0,2,1,66,0,0,0,251
49,35,14,6,12,2,0,0.0013869625520111,721
7,4,3,3,12,2,0,0.0104166666666667,96
22,16,6,4,18,2,0,0.00985221674876847,203
1,1,0,1,66,0,0,0,50
139,88,51,10,12,4,0,0.00130208333333333,768
47,39,8,1,23,0,0,0.00396825396825397,252
97,91,6,2,23,1,0,0.0102564102564103,195
120,96,24,8,16,1,0,0.00490196078431373,408
74,54,20,3,16,1,0,0.0172413793103448,58
0,0,0,1,2,1,0,0,0
0,0,0,1,2,1,0,0,0
0,0,0,1,2,1,0,0,0
99,78,21,4,0,0,0,0.00666666666666667,150
0,0,0,1,2,1,0,0,0
0,0,0,1,4,0,0,0,3
0,0,0,1,4,0,0,0,3
0,0,0,1,4,0,0,0,3
0,0,0,1,4,0,0,0,3
0,0,0,1,4,0,0,0.0588235294117647,17
0,0,0,1,4,0,0,0,3
0,0,0,1,0,0,0,0,36
0,0,0,1,0,0,0,0,181
3,2,1,2,18,0,0,0.00806451612903226,124
3,2,1,2,18,0,0,0.00806451612903226,124
0,0,0,2,7,0,0,0,0
375,237,138,12,2,1,0,0,203
0,0,0,1,4,0,0,0,147
0,0,0,1,4,0,0,0,147
0,0,0,1,4,0,0,0,149
0,0,0,1,4,0,0,0,148
0,0,0,1,4,0,0,0,103
0,0,0,1,4,0,0,0,39
2,1,1,2,4,0,0,0,242
0,0,0,1,4,0,0,0.00561797752808989,178
2,1,1,2,4,0,0,0,1072
0,0,0,1,4,0,0,0,191
4,3,1,3,4,0,0,0,0
0,0,0,2,65,0,0,0,0
147,13,134,6,12,2,0,0,0
76,76,0,3,12,0,0,0,0
4,2,2,3,12,2,0,0,0
21,1,20,3,12,1,0,0,0
0,0,0,1,4,0,0,0,0
4,3,1,4,4,0,0,0,0
0,0,0,2,65,0,0,0,0
107,3,104,7,12,2,0,0,0
0,0,0,1,12,0,0,0,0
63,63,0,2,12,0,0,0,0
5,3,2,4,12,0,0,0,0
1,0,1,2,12,0,0,0,0
0,0,0,1,4,0,0,0,0
0,0,0,1,12,0,0,0,0
161,26,135,13,12,4,0,0,0
5,1,4,3,12,1,0,0,0
4,3,1,3,4,0,0,0,0
0,0,0,2,65,0,0,0,0
0,0,0,1,4,0,0,0,0
475,263,212,13,7,3,0,0,0
216,109,107,12,7,3,0,0,0
555,253,302,20,5,7,0,0,0
81,34,47,12,12,5,0,0,0
65,41,24,13,5,5,0,0,0
824,511,313,12,7,3,0,0,0
25,8,17,5,12,2,0,0,0
311,146,165,12,7,3,0,0,0
4,3,1,4,4,0,0,0,0
0,0,0,2,65,0,0,0,0
8,0,8,2,18,1,0,0,0
0,0,0,1,18,0,0,0,0
0,0,0,1,18,0,0,0,0
0,0,0,1,18,0,0,0,0
0,0,0,1,4,0,0,0,0
0,0,0,2,7,0,0,0,0
126,63,63,8,7,1,0,0,0
0,0,0,2,12,0,0,0,0
0,0,0,2,12,0,0,0,0
0,0,0,2,12,0,0,0,0
0,0,0,2,4,0,0,0,0
4,3,1,3,4,0,0,0,0
0,0,0,2,65,0,0,0,0
2,1,1,2,12,0,0,0,0
2,1,1,2,12,1,0,0,0
121,103,18,4,12,1,0,0,0
3,0,3,2,12,1,0,0,0
0,0,0,1,12,0,0,0,0
0,0,0,1,12,0,0,0,0
5,4,1,2,12,0,0,0,0
8,7,1,3,12,0,0,0,0
196,99,97,14,12,4,0,0,0
26,21,5,3,12,0,0,0,0
26,22,4,4,12,0,0,0,0
2,1,1,2,12,0,0,0,0
0,0,0,1,12,0,0,0,0
10,5,5,4,12,1,0,0,0
63,17,46,4,12,0,0,0,0
4,3,1,3,4,0,0,0,0
0,0,0,2,65,0,0,0,0
36,19,17,2,4,0,0,0,0
0,0,0,1,4,0,0,0,0
20,10,10,2,4,0,0,0,0
74,37,37,3,4,1,0,0,0
34,19,15,3,4,0,0,0,0
61,50,11,4,4,0,0,0,0
24,9,15,3,65,0,0,0,0
0,0,0,1,65,0,0,0,0
0,0,0,1,65,0,0,0,0
4,2,2,2,54,0,0,0.00303030303030303,330
209,27,182,9,19,2,0,0,0
291,44,247,8,19,2,0,0,0
49,41,8,5,12,0,0,0,0
8,7,1,4,12,0,0,0,0
0,0,0,1,3,0,0,0.00917431192660551,109
0,0,0,1,3,0,0,0,244
0,0,0,1,3,0,0,0,217
0,0,0,1,3,0,0,0,83
0,0,0,1,3,0,0,0,77
0,0,0,2,3,0,0,0,0
0,0,0,2,3,0,0,0,0
0,0,0,2,3,0,0,0,0
0,0,0,2,3,0,0,0,0
0,0,0,2,3,0,0,0,0
0,0,0,1,12,0,0,0.00819672131147541,122
0,0,0,1,12,0,0,0,503
0,0,0,1,12,0,0,0,64
0,0,0,1,12,0,0,0,503
0,0,0,1,12,0,0,0,28
0,0,0,1,12,0,0,0.0191082802547771,157
0,0,0,1,12,0,0,0,31
24,24,0,3,12,0,0,0,0
0,0,0,2,12,0,0,0,0
0,0,0,1,12,0,0,0.0116279069767442,86
0,0,0,1,12,0,0,0.01,200
0,0,0,1,12,0,0,0.0151515151515152,66
0,0,0,1,12,0,0,0.00519480519480519,385
0,0,0,1,12,0,0,0.0172413793103448,348
0,0,0,1,12,0,0,0,30
0,0,0,1,12,0,0,0.0116279069767442,86
0,0,0,1,12,0,0,0,274
0,0,0,1,12,0,0,0,65
0,0,0,1,12,0,0,0.00261780104712042,382
0,0,0,1,12,0,0,0.0178571428571429,56
0,0,0,1,12,0,0,0,108
0,0,0,1,12,0,0,0,59
0,0,0,1,12,0,0,0.012987012987013,77
0,0,0,1,12,0,0,0.00714285714285714,140
2,1,1,2,2,1,0,0.00268096514745308,373
0,0,0,1,12,0,0,0.00189035916824197,529
0,0,0,1,12,0,0,0,97
0,0,0,1,12,0,0,0,295
0,0,0,1,12,0,0,0,61
0,0,0,1,12,0,0,0,79
0,0,0,1,12,0,0,0,545
60,31,29,5,0,0,0,0.0050251256281407,199
0,0,0,1,3,0,0,0,36
0,0,0,1,12,0,0,0.0103092783505155,97
0,0,0,1,12,0,0,0,34
0,0,0,1,12,0,0,0.00404858299595142,247
0,0,0,1,12,0,0,0,16
0,0,0,1,12,0,0,0.00675675675675676,148
0,0,0,1,12,0,0,0,40
0,0,0,1,12,0,0,0.00709219858156028,282
0,0,0,1,12,0,0,0,35
2,2,0,2,0,0,0,0.00643776824034335,466
9,5,4,6,19,2,0,0,0
21,13,8,4,19,2,0,0,0
4,2,2,3,20,0,0,0,0
402,35,367,7,19,3,0,0,0
413,15,398,8,19,4,0,0,0
555,55,500,11,19,6,0,0,0
220,145,75,11,12,4,0,0,0
0,0,0,1,20,0,0,0,0
0,0,0,1,20,0,0,0,0
1346,1262,84,1,84,0,0,7.4861506213505e-05,13358
708,701,7,1,84,0,0,0.000127000254000508,7874
2,1,1,1,84,0,0,0.000852514919011083,1173
5,3,2,2,34,0,0,0,192
6,4,2,3,34,0,0,0,383
3,3,0,2,34,0,0,0,108
2,2,0,2,34,0,0,0,335
2,2,0,2,34,0,0,0,117
202,190,12,8,31,0,0,0,3001
32,20,12,5,39,2,0,0,100
133,70,63,7,39,2,0,0,178
104,50,54,4,40,3,0,0,340
1,1,0,1,41,0,0,0,328
11,5,6,3,39,0,0,0,83
2,1,1,1,61,0,0,0,302
0,0,0,1,31,0,0,0,0
0,0,0,1,31,0,0,0,0
0,0,0,1,31,0,0,0,0
7,6,1,2,31,1,0,0,0
0,0,0,1,31,0,0,0,0
0,0,0,1,31,0,0,0,0
0,0,0,1,31,0,0,0,0
0,0,0,1,31,0,0,0,0
0,0,0,1,31,0,0,0,0
0,0,0,1,31,0,0,0,0
0,0,0,1,31,0,0,0,0
0,0,0,1,31,0,0,0,0
0,0,0,1,31,0,0,0,0
0,0,0,1,31,0,0,0,0
0,0,0,1,31,0,0,0,0
0,0,0,1,31,0,0,0,0
0,0,0,1,31,0,0,0,0
0,0,0,1,31,0,0,0,0
6,5,1,2,31,1,0,0,0
0,0,0,1,31,0,0,0,0
0,0,0,1,31,0,0,0,0
0,0,0,1,31,0,0,0,0
0,0,0,1,31,0,0,0,0
0,0,0,1,31,0,0,0,0
0,0,0,1,31,0,0,0,0
0,0,0,1,31,0,0,0,0
0,0,0,1,31,0,0,0,0
0,0,0,1,31,0,0,0,0
1,1,0,1,78,0,0,0,121
2,1,1,1,78,0,0,0,404
1,0,1,1,59,0,0,0,346
6,6,0,1,44,0,0,0,139
1,0,1,1,59,0,0,0,588
1,1,0,1,44,0,0,0,167
3,3,0,1,42,0,0,0,113
22,14,8,2,42,0,0,0,204
12,7,5,3,42,0,0,0,112
1,0,1,1,59,0,0,0,102
1,1,0,1,86,0,0,0,79
2,1,1,1,89,0,0,0,48
3,3,0,1,86,0,0,0,142
1,0,1,1,59,0,0,0,116
3,3,0,1,77,0,0,0,489
1,0,1,1,59,0,0,0,169
2,0,2,1,59,0,0,0,274
2,2,0,1,78,0,0,0,148
14,7,7,7,85,0,0,0,132
5,4,1,2,59,0,0,0,136
2,2,0,1,77,0,0,0,52
4,4,0,1,77,0,0,0,1304
1,0,1,1,59,0,0,0,113
1,1,0,1,46,0,0,0,73
8,8,0,1,89,0,0,0,152
30,21,9,2,89,0,0,0,860
2,2,0,2,41,0,0,0,936
2,2,0,1,44,0,0,0,192
3,3,0,1,89,0,0,0,182
2,1,1,2,31,0,0,0,794
2,0,2,1,59,0,0,0,81
1,0,1,1,59,0,0,0,8940
0,0,0,1,31,0,0,0,0
0,0,0,1,31,0,0,0,0
0,0,0,1,31,0,0,0,0
0,0,0,1,31,0,0,0,0
0,0,0,1,31,0,0,0,0
0,0,0,1,31,0,0,0,0
0,0,0,1,31,0,0,0,0
0,0,0,1,31,0,0,0,0
0,0,0,1,31,0,0,0,0
0,0,0,1,31,0,0,0,0
0,0,0,1,31,0,0,0,0
0,0,0,1,31,0,0,0,0
0,0,0,1,31,0,0,0,0
0,0,0,1,31,0,0,0,0
0,0,0,1,31,0,0,0,0
0,0,0,1,31,0,0,0,0
0,0,0,1,31,0,0,0,0
0,0,0,1,31,0,0,0,0
0,0,0,1,31,0,0,0,0
0,0,0,1,31,0,0,0,0
0,0,0,1,31,0,0,0,0
0,0,0,1,31,0,0,0,0
0,0,0,1,31,0,0,0,0
0,0,0,1,31,0,0,0,0
0,0,0,1,31,0,0,0,0
0,0,0,1,31,0,0,0,0
0,0,0,1,31,0,0,0,0
0,0,0,1,31,0,0,0,0
0,0,0,1,31,0,0,0,0
0,0,0,1,31,0,0,0,0
0,0,0,1,31,0,0,0,0
0,0,0,1,31,0,0,0,0
0,0,0,1,31,0,0,0,0
0,0,0,1,31,0,0,0,0
0,0,0,1,31,0,0,0,0
0,0,0,1,31,0,0,0,0
0,0,0,1,31,0,0,0,0
0,0,0,1,31,0,0,0,0
0,0,0,1,31,0,0,0,0
0,0,0,1,31,0,0,0,0
0,0,0,1,31,0,0,0,0
0,0,0,1,31,0,0,0,0
0,0,0,1,31,0,0,0,0
0,0,0,1,31,0,0,0,0
0,0,0,1,31,0,0,0,0
0,0,0,1,31,0,0,0,0
0,0,0,1,31,0,0,0,0
0,0,0,1,31,0,0,0,0
0,0,0,1,31,0,0,0,0
0,0,0,1,31,0,0,0,0
0,0,0,1,31,0,0,0,0
0,0,0,1,31,0,0,0,0
0,0,0,1,31,0,0,0,0
0,0,0,1,31,0,0,0,0
0,0,0,1,31,0,0,0,0
0,0,0,1,31,0,0,0,0
0,0,0,1,31,0,0,0,0
0,0,0,1,31,0,0,0,0
0,0,0,1,31,0,0,0,0
0,0,0,1,31,0,0,0,0
0,0,0,1,31,0,0,0,0
0,0,0,1,31,0,0,0,0
0,0,0,1,31,0,0,0,0
0,0,0,1,31,0,0,0,0
0,0,0,1,31,0,0,0,0
0,0,0,1,31,0,0,0,0
1,1,0,1,84,1,0,0,357
1,1,0,1,84,1,0,0,2074
1,1,0,1,84,1,0,0,2076
5,4,1,1,42,0,0,0,422
2,2,0,1,29,0,0,0,1391
1,0,1,1,57,0,0,0,55
1,0,1,1,57,0,0,0,677
1,1,0,1,84,1,0,0,1779
1,1,0,1,84,1,0,0,1789
1,1,0,1,84,1,0,0,1898
1,0,1,1,57,0,0,0,393
1,0,1,1,57,0,0,0,188
5,4,1,1,84,1,0,0,2454
2,1,1,2,42,0,0,0,607
5,4,1,1,84,1,0,0,2454
1,1,0,1,84,1,0,0,1778
1,1,0,1,84,1,0,0,2061
4,4,0,1,84,1,0,0,46
1,0,1,1,57,0,0,0,203
2,1,1,1,81,0,0,0,531
0,0,0,1,31,0,0,0,0
0,0,0,1,31,0,0,0,0
0,0,0,1,31,0,0,0,0
0,0,0,1,31,0,0,0,0
0,0,0,1,31,0,0,0,0
0,0,0,1,31,0,0,0,0
0,0,0,1,31,0,0,0,0
0,0,0,1,31,0,0,0,0
0,0,0,1,31,0,0,0,0
0,0,0,1,31,0,0,0,0
0,0,0,1,31,0,0,0,0
0,0,0,1,31,0,0,0,0
0,0,0,1,31,0,0,0,0
0,0,0,1,31,0,0,0,0
0,0,0,1,31,0,0,0,0
0,0,0,1,31,0,0,0,0
0,0,0,1,31,0,0,0,0
0,0,0,1,31,0,0,0,0
0,0,0,1,31,0,0,0,0
0,0,0,1,31,0,0,0,0
0,0,0,1,31,0,0,0,0
0,0,0,1,31,0,0,0,0
0,0,0,1,31,0,0,0,0
0,0,0,1,31,0,0,0,0
0,0,0,1,31,0,0,0,0
0,0,0,1,31,0,0,0,0
0,0,0,1,31,0,0,0,0
0,0,0,1,31,0,0,0,0
0,0,0,1,31,0,0,0,0
0,0,0,1,31,0,0,0,0
0,0,0,1,31,0,0,0,0
0,0,0,1,31,0,0,0,0
0,0,0,1,31,0,0,0,0
0,0,0,1,31,0,0,0,0
0,0,0,1,31,0,0,0,0
0,0,0,1,31,0,0,0,0
0,0,0,1,31,0,0,0,0
0,0,0,1,31,0,0,0,0
0,0,0,1,31,0,0,0,0
0,0,0,1,31,0,0,0,0
0,0,0,1,31,0,0,0,0
0,0,0,1,31,0,0,0,0
0,0,0,1,31,0,0,0,0
0,0,0,1,31,0,0,0,0
0,0,0,1,31,0,0,0,0
0,0,0,1,31,0,0,0,0
0,0,0,1,31,0,0,0,0
0,0,0,1,31,0,0,0,0
0,0,0,1,31,0,0,0,0
0,0,0,1,31,0,0,0,0
0,0,0,1,31,0,0,0,0
0,0,0,1,31,0,0,0,0
0,0,0,1,31,0,0,0,0
2,1,1,2,25,0,0,0,637
2,2,0,2,85,0,0,0,0
0,0,0,2,85,0,0,0,0
0,0,0,2,85,0,0,0,0
0,0,0,1,47,0,0,0,142
0,0,0,1,47,0,0,0,189
63,57,6,6,6,1,0,0.00146412884333821,683
0,0,0,1,47,0,0,0,106
48,31,17,4,23,0,0,0.0117647058823529,680
0,0,0,1,47,0,0,0,450
0,0,0,1,47,0,0,0,63
4,1,3,3,23,0,0,0,749
259,147,112,9,0,1,0,0,491
0,0,0,1,47,0,0,0,132
42,6,36,3,37,0,0,0,514
2,0,2,2,37,0,0,0,52
9,3,6,4,26,1,0,0,721
0,0,0,1,47,0,0,0,177
8,7,1,4,25,0,0,0,809
441,221,220,17,6,2,1,0.00252047889098929,3174
0,0,0,1,47,0,0,0,513
3,3,0,2,23,0,0,0.00376293508936971,1063
0,0,0,1,47,0,0,0,714
0,0,0,1,47,0,0,0,292
0,0,0,1,47,0,0,0,473
0,0,0,1,47,0,0,0,20
7,3,4,4,25,1,0,0,10668
4,2,2,3,25,1,0,0,721
0,0,0,1,47,0,0,0,785
0,0,0,1,47,0,0,0,41
6,3,3,3,25,1,0,0,388
6,3,3,3,25,1,0,0,88
0,0,0,1,47,0,0,0,343
0,0,0,1,47,0,0,0,85
3,2,1,2,30,1,0,0,1986
0,0,0,1,47,0,0,0,64
0,0,0,1,47,0,0,0,311
2,1,1,2,25,0,0,0,293
0,0,0,1,47,0,0,0,112
0,0,0,1,47,0,0,0,0
0,0,0,1,47,0,0,0,0
12,6,6,2,47,0,0,0,0
0,0,0,1,47,0,0,0,0
0,0,0,1,47,0,0,0,0
0,0,0,1,47,0,0,0,243
0,0,0,1,47,0,0,0,213
0,0,0,1,47,0,0,0,461
2,1,1,2,25,0,0,0,352
0,0,0,1,47,0,0,0,381
0,0,0,1,47,0,0,0,218
3,3,0,2,16,0,0,0,977
0,0,0,1,47,0,0,0,196
0,0,0,1,47,0,0,0,212
32,16,16,2,47,0,0,0,0
0,0,0,1,47,0,0,0,0
1,0,1,2,47,0,0,0,0
34,28,6,3,47,1,0,0,0
0,0,0,1,47,0,0,0,0
63,42,21,7,47,2,0,0,0
0,0,0,1,47,0,0,0,0
0,0,0,1,47,0,0,0,0
3,1,2,3,47,0,0,0,0
1,0,1,2,47,0,0,0,0
0,0,0,1,47,0,0,0,0
0,0,0,1,47,0,0,0,0
0,0,0,1,47,0,0,0,0
2,0,2,2,47,0,0,0,0
0,0,0,1,47,0,0,0,0
5,5,0,2,47,1,0,0,0
0,0,0,1,47,0,0,0,0
5,1,4,3,47,1,0,0,0
20,15,5,5,47,2,0,0,0
1,0,1,2,47,0,0,0,0
0,0,0,1,47,0,0,0,0
0,0,0,1,47,0,0,0,0
0,0,0,1,47,0,0,0,0
5,3,2,3,47,0,0,0,0
4,2,2,2,47,0,0,0,0
0,0,0,1,47,0,0,0,0
0,0,0,1,47,0,0,0,0
5,3,2,3,47,0,0,0,0
4,2,2,2,47,0,0,0,0
0,0,0,1,47,0,0,0,0
0,0,0,1,47,0,0,0,0
0,0,0,1,47,0,0,0,0
0,0,0,1,47,0,0,0,0
0,0,0,1,47,0,0,0,0
0,0,0,1,47,0,0,0,0
0,0,0,1,47,0,0,0,0
0,0,0,1,47,0,0,0,0
0,0,0,1,47,0,0,0,0
0,0,0,1,47,0,0,0,0
0,0,0,1,47,0,0,0,0
0,0,0,1,47,0,0,0,0
0,0,0,1,47,0,0,0,0
3,2,1,2,47,0,0,0,0
3,2,1,2,47,0,0,0,0
0,0,0,1,47,0,0,0,0
0,0,0,1,47,0,0,0,0
0,0,0,1,47,0,0,0,0
0,0,0,1,47,0,0,0,0
0,0,0,1,47,0,0,0,124
0,0,0,1,47,0,0,0,367
0,0,0,1,47,0,0,0,377
0,0,0,1,31,0,0,0,0
0,0,0,1,31,0,0,0,0
0,0,0,1,31,0,0,0,0
0,0,0,1,31,0,0,0,0
4,1,3,1,32,0,0,0,1573
30,19,11,5,32,0,0,0,345
204,128,76,15,16,6,0,0.000350877192982456,2850
0,0,0,1,31,0,0,0,0
0,0,0,1,31,0,0,0,0
0,0,0,1,31,0,0,0,0
0,0,0,1,31,0,0,0,0
0,0,0,1,31,0,0,0,0
0,0,0,1,31,0,0,0,0
0,0,0,1,31,0,0,0,0
0,0,0,1,31,0,0,0,0
0,0,0,1,31,0,0,0,0
0,0,0,1,31,0,0,0,0
0,0,0,1,31,0,0,0,0
0,0,0,1,31,0,0,0,0
0,0,0,1,31,0,0,0,0
0,0,0,1,31,0,0,0,0
0,0,0,1,31,0,0,0,0
0,0,0,1,31,0,0,0,0
0,0,0,1,31,0,0,0,0
0,0,0,1,31,0,0,0,0
10,5,5,3,31,0,0,0,0
0,0,0,1,31,0,0,0,0
0,0,0,1,31,0,0,0,0
0,0,0,1,31,0,0,0,0
0,0,0,1,31,0,0,0,0
0,0,0,1,31,0,0,0,0
0,0,0,1,31,0,0,0,0
0,0,0,1,31,0,0,0,0
0,0,0,1,31,0,0,0,0
0,0,0,1,31,0,0,0,0
0,0,0,1,31,0,0,0,0
0,0,0,1,31,0,0,0,0
0,0,0,1,31,0,0,0,0
8,0,8,1,44,0,0,0,290
2,1,1,3,9,0,0,0,0
9,3,6,5,9,0,0,0,0
83,81,2,4,5,3,0,0,89
117,51,66,11,14,1,0,0.00105932203389831,944
34,22,12,8,14,1,0,0,567
17,4,13,4,32,1,0,0,200
8,4,4,1,86,0,0,0,79
7,7,0,2,3,0,0,0.00364963503649635,274
92,56,36,3,2,0,0,0,132
23,5,18,1,29,0,0,0,325
25,6,19,2,29,1,0,0,884
67,41,26,7,14,1,0,0,798
6,5,1,2,14,0,0,0,123
20,10,10,1,86,0,0,0,434
16,8,8,1,86,0,0,0,75
9,1,8,2,14,0,0,0,1001
61,33,28,5,31,0,0,0,0
6,3,3,2,65,0,0,0,0
3,1,2,3,31,0,0,0,0
0,0,0,1,31,0,0,0,0
7,2,5,3,31,0,0,0,0
0,0,0,1,31,0,0,0,0
4,2,2,2,31,0,0,0,0
4,0,4,2,31,0,0,0,0
0,0,0,1,31,0,0,0,0
9,4,5,3,31,0,0,0,0
0,0,0,1,31,0,0,0,0
0,0,0,1,31,0,0,0,0
0,0,0,1,31,0,0,0,0
4,0,4,2,31,0,0,0,0
0,0,0,1,31,0,0,0,0
0,0,0,1,31,0,0,0,0
0,0,0,1,31,0,0,0,0
2,0,2,2,31,0,0,0,0
0,0,0,1,31,0,0,0,0
0,0,0,1,31,0,0,0,0
0,0,0,1,31,0,0,0,0
4,1,3,3,31,0,0,0,0
0,0,0,1,31,0,0,0,0
11,3,8,3,31,0,0,0,0
0,0,0,1,31,0,0,0,0
10,4,6,3,31,0,0,0,0
0,0,0,1,31,0,0,0,0
0,0,0,1,31,0,0,0,0
0,0,0,1,31,0,0,0,0
2,1,1,2,31,0,0,0,0
0,0,0,1,31,0,0,0,0
0,0,0,1,31,0,0,0,0
6,2,4,3,31,0,0,0,0
0,0,0,1,31,0,0,0,0
0,0,0,1,31,0,0,0,0
0,0,0,1,31,0,0,0,0
0,0,0,1,31,0,0,0,0
45,25,20,6,31,1,0,0,0
2,1,1,2,31,0,0,0,0
0,0,0,1,31,0,0,0,0
0,0,0,1,31,0,0,0,0
0,0,0,1,31,0,0,0,0
0,0,0,1,31,0,0,0,0
7,4,3,4,31,0,0,0,0
15,7,8,4,31,0,0,0,0
3,2,1,3,31,0,0,0,0
3,2,1,3,31,0,0,0,0
6,3,3,3,31,0,0,0,0
0,0,0,1,31,0,0,0,0
6,3,3,2,31,0,0,0,0
0,0,0,1,31,0,0,0,0
5,3,2,3,31,0,0,0,0
6,3,3,3,31,0,0,0,0
2,1,1,2,31,0,0,0,0
13,7,6,5,31,0,0,0,0
19,9,10,6,31,0,0,0,0
6,3,3,3,31,0,0,0,0
5,3,2,4,31,0,0,0,0
2,1,1,2,31,0,0,0,0
9,5,4,5,31,0,0,0,0
0,0,0,1,31,0,0,0,0
0,0,0,1,31,0,0,0,0
10,5,5,5,31,0,0,0,0
0,0,0,1,31,0,0,0,0
38,23,15,5,31,0,0,0,0
0,0,0,1,31,0,0,0,0
0,0,0,1,31,0,0,0,0
27,12,15,2,67,0,0,0,572
4,2,2,1,86,0,0,0,249
8,4,4,2,80,0,0,0,519
4,2,2,1,86,0,0,0,48
1,0,1,1,67,0,0,0,172
31,17,14,6,37,1,0,0,361
16,8,8,1,86,0,0,0,99
4,2,2,1,86,0,0,0,138
4,1,3,2,67,0,0,0,1002
6,2,4,2,67,0,0,0,547
1,0,1,1,85,1,0,0,77
2,1,1,2,29,0,0,0,184
1,0,1,1,30,0,0,0,872
5,2,3,2,37,0,0,0,486
0,0,0,1,22,0,0,0,0
6,1,5,3,60,0,0,0,113
13,5,8,4,25,1,0,0,220
0,0,0,1,60,0,0,0,0
3,0,3,1,60,0,0,0,1136
67,23,44,3,11,0,0,0,346
155,68,87,6,25,1,0,0,730
10,2,8,4,37,0,0,0,186
13,4,9,4,26,1,0,0,371
178,88,90,1,37,0,0,0,847
83,39,44,2,37,0,0,0,328
7,5,2,1,52,0,0,0.00145454545454545,1375
0,0,0,1,60,0,0,0,0
3,0,3,1,60,0,0,0,1160
31,14,17,2,11,0,0,0.00403225806451613,496
55,18,37,4,11,0,0,0.0024330900243309,411
170,74,96,9,26,1,0,0.00148588410104012,673
0,0,0,1,82,0,0,0,0
29,13,16,10,10,4,0,0.000784929356357928,1274
0,0,0,1,22,0,0,0,0
5,1,4,2,65,0,0,0,335
15,8,7,1,69,0,0,0,276
1,0,1,1,65,0,0,0,281
1,0,1,1,65,0,0,0,55
4,1,3,2,65,0,0,0,183
1,0,1,1,65,0,0,0.00163934426229508,610
1,0,1,1,65,0,0,0,504
1,0,1,1,65,0,0,0,400
19,6,13,6,18,1,0,0,202
25,17,8,6,18,0,0,0,765
76,45,31,7,24,0,0,0.00256410256410256,390
137,131,6,11,9,2,0,0.000922509225092251,1084
14,10,4,4,6,0,0,0,910
21,6,15,6,37,1,0,0,480
94,35,59,6,24,0,0,0.00137931034482759,725
4,2,2,1,37,0,0,0,254
6,6,0,2,18,1,0,0,974
14,7,7,1,37,0,0,0,95
135,97,38,8,9,3,0,0,1482
4,0,4,3,57,0,0,0,141
13,7,6,1,69,0,0,0.00485436893203883,206
1,0,1,1,65,0,0,0,211
4,1,3,2,65,0,0,0,148
59,45,14,5,55,0,0,0,641
0,0,0,1,18,1,0,0,115
39,29,10,4,20,2,0,0,177
8,4,4,2,37,0,0,0,254
55,29,26,3,20,2,0,0.00495049504950495,202
12,2,10,2,20,2,0,0,109
270,168,102,2,20,2,0,0,774
10,4,6,3,61,0,0,0.00273224043715847,366
44,33,11,7,17,0,0,0,195
59,54,5,3,17,0,0,0,99
187,67,120,5,37,0,0,0,534
1,0,1,1,57,0,0,0.00448430493273543,223
20,11,9,5,38,0,0,0,498
100,98,2,1,58,0,0,0.00118694362017804,1685
24,9,15,2,11,0,0,0.00460829493087558,217
6,3,3,1,37,0,0,0,252
33,26,7,2,69,0,0,0.00699300699300699,143
3,3,0,2,69,0,0,0.010989010989011,91
379,231,148,16,9,7,0,0,1801
3,1,2,1,69,0,0,0,204
16,6,10,5,23,0,0,0,234
21,12,9,4,24,0,0,0,201
28,12,16,4,37,1,0,0,390
15,13,2,4,9,3,0,0.0022075055187638,453
68,34,34,1,37,0,0,0,174
269,185,84,15,9,5,0,0,1723
14,7,7,1,37,0,0,0,1176
389,144,245,12,4,7,0,0,2141
4,2,2,1,37,0,0,0,445
29,16,13,5,23,0,0,0.00278551532033426,359
3,1,2,1,69,0,0,0,303
167,69,98,8,11,2,0,0.00268096514745308,746
24,12,12,6,23,0,0,0,296
7,3,4,4,6,0,0,0,75
4,0,4,2,31,0,0,0,165
36,19,17,5,9,0,0,0,92
5,1,4,3,31,0,0,0,71
5,1,4,2,31,0,0,0,105
46,42,4,4,23,1,0,0.0053475935828877,187
6,4,2,2,31,1,0,0,83
8,3,5,2,31,0,0,0,173
49,26,23,7,9,0,0,0,120
92,45,47,3,24,0,0,0,160
0,0,0,1,82,0,0,0,0
0,0,0,1,22,0,0,0,0
139,53,86,11,17,1,0,0.0102040816326531,294
165,80,85,8,17,0,0,0,171
582,196,386,17,6,5,0,0,500
2,1,1,1,86,0,0,0,73
154,142,12,3,24,0,0,0,734
146,29,117,9,5,3,0,0,324
6,0,6,1,61,0,0,0,56
5,1,4,2,64,0,0,0,203
518,128,390,29,0,3,1,0.00446428571428571,896
114,13,101,15,9,1,0,0.00208768267223382,479
0,0,0,1,24,0,0,0,0
7,7,0,4,33,1,0,0,218
3,3,0,1,79,0,0,0,39
76,50,26,9,11,2,1,0.00146412884333821,683
28,1,27,3,24,0,1,0.00892857142857143,112
137,30,107,11,4,6,0,0,478
16,4,12,2,11,0,0,0,217
15,4,11,2,64,0,0,0,169
154,60,94,8,37,1,0,0,522
234,102,132,9,4,5,0,0,214
8,2,6,3,37,0,0,0.003584229390681,279
252,67,185,8,37,2,0,0,196
4,3,1,1,10,0,0,0,247
228,67,161,18,4,8,0,0,506
22,16,6,9,4,4,0,0,159
822,275,547,37,12,1,1,0,564
58,10,48,7,24,0,0,0,68
594,86,508,9,12,3,0,0.00268817204301075,372
0,0,0,1,24,0,0,0,0
2,0,2,1,64,0,0,0,211
178,5,173,6,64,0,0,0,0
6,3,3,2,86,0,0,0,0
4,2,2,1,37,0,0,0,132
4,2,2,1,37,0,0,0,228
2,0,2,1,23,0,0,0,71
21,6,15,7,11,2,0,0,332
1,0,1,1,57,0,0,0.0131004366812227,229
118,75,43,13,11,4,1,0,857
14,5,9,1,11,0,0,0.00735294117647059,136
4,0,4,1,23,0,0,0,80
6,2,4,2,39,1,0,0.00452488687782805,221
2,0,2,1,64,0,0,0,304
0,0,0,1,22,0,0,0,0
21,10,11,4,14,0,0,0,357
18,9,9,1,86,0,0,0,368
3,0,3,1,67,0,0,0,132
4,2,2,1,86,0,0,0,932
2,1,1,1,86,0,0,0,148
5,2,3,2,67,0,0,0,95
30,17,13,5,46,1,0,0,463
2,1,1,1,86,0,0,0,80
9,4,5,2,67,0,0,0,168
17,6,11,4,32,0,0,0,1186
9,2,7,2,67,0,0,0,565
6,3,3,2,29,0,0,0,511
2,0,2,1,67,0,0,0,522
1,0,1,1,30,0,0,0,1927
5,2,3,2,37,0,0,0,641
45,25,20,5,46,1,0,0,1005
2,1,1,1,86,0,0,0,154
6,3,3,1,86,0,0,0,359
5,0,5,1,64,0,0,0,74
9,3,6,2,64,0,0,0,747
2,1,1,1,86,0,0,0,110
30,15,15,3,37,0,0,0,655
1,0,1,1,64,0,0,0,170
8,4,4,1,86,0,0,0,227
19,7,12,3,32,0,0,0,1197
7,2,5,2,64,0,0,0,540
1,1,0,1,29,0,0,0,278
2,0,2,2,30,0,0,0,914
5,2,3,2,37,0,0,0,478
0,0,0,1,22,0,0,0,0
8,3,5,2,39,1,0,0,182
0,0,0,1,55,0,0,0,107
6,3,3,2,38,0,0,0,172
0,0,0,1,55,0,0,0,39
222,147,75,11,6,2,0,0,345
39,28,11,4,18,1,0,0.00819672131147541,122
10,6,4,5,6,1,0,0,142
4,1,3,3,37,1,0,0,87
13,5,8,6,6,2,0,0,274
0,0,0,1,55,0,0,0,51
19,19,0,2,10,0,0,0,282
4,2,2,2,7,0,0,0,98
2,1,1,2,17,1,0,0,361
65,27,38,5,35,1,0,0,258
16,0,16,2,39,1,0,0,38
41,31,10,3,6,1,0,0,195
38,28,10,8,6,2,0,0,550
5,4,1,3,10,0,0,0,122
0,0,0,1,55,0,0,0,81
0,0,0,1,55,0,0,0,58
2,1,1,2,39,1,0,0,354
516,335,181,10,6,1,0,0,610
12,10,2,4,7,0,0,0,57
36,36,0,3,10,0,0,0,212
136,95,41,8,7,2,0,0,463
230,202,28,6,10,2,0,0,292
7,1,6,2,39,1,0,0,47
8,2,6,2,39,1,0,0,93
0,0,0,1,55,0,0,0,212
0,0,0,2,39,1,0,0,0
10,5,5,3,21,1,0,0,116
76,46,30,2,33,0,0,0,277
23,20,3,6,21,1,0,0,331
7,6,1,4,31,0,0,0,167
268,159,109,5,34,1,0,0,597
357,346,11,6,10,1,0,0,426
25,12,13,5,10,1,0,0,191
0,0,0,1,55,0,0,0,201
0,0,0,2,39,1,0,0,0
7,3,4,4,7,0,0,0,189
240,116,124,3,31,0,0,0,408
0,0,0,1,55,0,0,0,126
5,0,5,2,24,0,0,0,181
108,101,7,8,7,0,0,0,236
63,19,44,4,7,1,0,0,489
499,477,22,7,10,1,0,0,516
24,14,10,5,10,1,0,0,116
0,0,0,1,55,0,0,0,225
0,0,0,2,39,1,0,0,0
6,2,4,3,7,0,0,0,121
0,0,0,1,33,0,0,0,73
0,0,0,1,55,0,0,0,44
0,0,0,1,55,0,0,0,42
128,115,13,8,7,0,0,0,269
59,16,43,4,7,1,0,0,369
15,7,8,2,57,0,0,0,369
18,9,9,1,86,0,0,0,260
3,0,3,1,57,0,0,0,143
6,3,3,1,86,0,0,0,820
4,2,2,1,86,0,0,0,143
6,2,4,2,57,0,0,0,107
30,18,12,5,46,1,0,0,525
2,1,1,1,86,0,0,0,85
10,4,6,2,57,0,0,0,449
14,5,9,4,32,0,0,0,1441
9,2,7,2,57,0,0,0,615
4,1,3,2,29,0,0,0,299
1,0,1,1,57,0,0,0,645
1,0,1,1,30,0,0,0,797
0,0,0,1,22,0,0,0,0
311,238,73,18,17,6,0,0,541
42,22,20,3,25,0,0,0,56
10,4,6,4,7,3,0,0,353
34,18,16,11,16,3,0,0,512
14,8,6,2,69,0,0,0,658
10,4,6,3,32,1,0,0,396
4,2,2,1,54,1,0,0,227
20,10,10,3,19,0,0,0,0
0,0,0,1,19,0,0,0,0
8,7,1,3,17,2,0,0,1597
1,0,1,1,57,0,0,0,1456
51,33,18,9,16,1,0,0,2545
2,1,1,1,16,1,0,0,63
25,17,8,5,48,3,0,0,1626
2,0,2,2,30,0,0,0,947
65,37,28,4,7,3,0,0,721
65,42,23,5,49,1,0,0,542
2,1,1,1,68,0,0,0,57
0,0,0,2,68,0,0,0,0
43,33,10,2,47,2,0,0,1736
9,6,3,2,52,0,0,0,1272
0,0,0,1,19,0,0,0,0
0,0,0,1,68,0,0,0,0
0,0,0,1,70,0,0,0,0
0,0,0,1,71,0,0,0,0
0,0,0,1,71,0,0,0,0
0,0,0,1,22,0,0,0,0
0,0,0,1,65,0,0,0,0
4,3,1,1,84,0,0,0,97
2,1,1,1,42,0,0,0,380
5,1,4,1,42,0,0,0.00531914893617021,188
2,1,1,1,46,1,0,0.00415800415800416,481
27,19,8,4,8,3,0,0.00203665987780041,491
3,2,1,1,84,0,0,0,173
11,7,4,1,84,0,0,0,309
3,3,0,2,42,0,0,0,112
2,1,1,1,81,0,0,0,350
4,2,2,1,53,1,0,0.00381679389312977,262
6,4,2,1,79,0,0,0,183
14,7,7,1,81,0,0,0,233
71,56,15,2,2,0,0,0.00254777070063694,785
10,5,5,1,81,0,0,0,126
195,121,74,17,15,6,0,0.0015220700152207,657
44,23,21,2,25,0,0,0,56
124,56,68,6,7,1,0,0,907
51,31,20,14,16,2,0,0.00176678445229682,566
8,2,6,4,21,0,0,0,559
37,29,8,5,38,1,0,0,750
8,0,8,2,57,0,0,0,135
25,19,6,8,7,1,0,0,303
2,0,2,1,64,0,0,0,0
3,3,0,1,64,0,0,0,3313
8,1,7,2,37,0,0,0.00405679513184584,493
11,7,4,2,37,0,0,0,145
159,96,63,18,16,4,0,0.000413907284768212,2416
2,1,1,1,16,1,0,0,62
1,0,1,1,30,0,0,0,683
55,47,8,4,21,0,0,0,386
5,4,1,2,21,0,0,0,59
7,1,6,3,68,0,0,0,0
10,4,6,2,47,1,0,0,524
50,30,20,11,7,3,0,0,414
0,0,0,1,19,0,0,0,0
0,0,0,1,68,0,0,0,0
0,0,0,1,70,0,0,0,0
0,0,0,1,71,0,0,0,0
0,0,0,1,71,0,0,0,0
0,0,0,1,22,0,0,0,0
0,0,0,1,65,0,0,0,0
2314,1680,634,18,20,3,0,0,1659
75,54,21,4,25,0,0,0,54
0,0,0,1,72,0,0,0,28
2,0,2,1,57,0,0,0,518
59,34,25,15,16,3,0,0,446
10,8,2,6,68,0,0,0,194
2,0,2,1,57,0,0,0,115
15,8,7,3,57,0,0,0,431
4,2,2,2,60,0,0,0,63
11,4,7,5,68,0,0,0,0
183,132,51,9,30,2,0,0,1116
119,95,24,10,29,3,0,0.000150195253829979,6658
5,5,0,4,69,1,0,0,683
48,32,16,8,32,3,0,0,1372
5,2,3,3,57,0,0,0,121
22,21,1,1,82,0,0,0,785
2,0,2,1,57,0,0,0,48
6,4,2,2,37,0,0,0,172
32,21,11,6,26,2,0,0,1010
1,0,1,1,57,0,0,0,621
64,35,29,14,13,3,0,0,1869
2,1,1,1,16,1,0,0,47
24,16,8,6,16,0,0,0,702
2,2,0,2,89,0,0,0,102
0,0,0,1,19,0,0,0,0
0,0,0,1,68,0,0,0,0
0,0,0,1,70,0,0,0,0
0,0,0,1,71,0,0,0,0
0,0,0,1,71,0,0,0,0
0,0,0,1,22,0,0,0,0
0,0,0,1,65,0,0,0,0
156,101,55,15,18,5,0,0,418
42,22,20,3,25,0,0,0,56
8,4,4,2,37,0,0,0,234
1,1,0,1,25,0,0,0,451
37,14,23,4,60,1,0,0,1338
21,17,4,3,19,0,0,0,101
19,7,12,2,57,0,0,0,789
44,33,11,4,21,0,0,0,618
27,15,12,8,21,1,0,0,420
5,2,3,3,68,0,0,0,458
5,2,3,3,64,2,0,0.00240384615384615,416
6,5,1,1,52,0,0,0,174
23,14,9,2,13,1,0,0.0020746887966805,482
198,124,74,8,21,1,0,0,633
27,8,19,7,32,4,1,0,639
0,0,0,1,60,0,0,0,0
7,3,4,2,57,0,0,0,166
258,146,112,13,17,2,1,0,656
13,10,3,4,21,0,1,0,101
27,19,8,3,15,2,0,0,199
6,3,3,2,37,0,0,0.00411522633744856,243
1,0,1,1,57,0,0,0,1080
53,30,23,7,25,1,0,0,1760
4,2,2,1,86,0,0,0,127
8,8,0,1,47,0,0,0,971
35,18,17,7,16,1,0,0,2294
4,0,4,1,57,0,0,0,1162
2,0,2,2,30,0,0,0,857
3,2,1,3,57,2,0,0,642
13,8,5,3,57,0,0,0,469
2,1,1,1,68,0,0,0,57
88,76,12,10,15,2,0,0,215
0,0,0,1,70,0,0,0,95
0,0,0,2,68,0,0,0,0
8,4,4,1,47,1,0,0,1175
245,136,109,10,21,1,0,0.0009765625,1024
13,12,1,3,21,0,0,0,140
274,270,4,5,21,0,0,0,512
6,6,0,3,50,0,0,0,38
0,0,0,1,22,0,0,0,0
0,0,0,1,65,0,0,0,0
25,24,1,1,69,0,0,0,2174
2,1,1,1,86,0,0,0,157
73,40,33,5,37,1,0,0.00099009900990099,1010
6,3,3,1,86,0,0,0,321
4,0,4,1,64,0,0,0,97
20,9,11,3,64,0,0,0,662
2,1,1,1,86,0,0,0,203
1,0,1,1,64,0,0,0,369
5,2,3,2,64,0,0,0,282
11,5,6,4,29,0,0,0,2126
2,0,2,2,30,0,0,0,1306
2,0,2,1,64,0,0,0,735
19,9,10,3,64,0,0,0,718
18,9,9,1,86,0,0,0,478
2,0,2,1,64,0,0,0,267
1,0,1,1,64,0,0,0,205
4,2,2,1,86,0,0,0,80
30,18,12,5,46,1,0,0,333
2,1,1,1,86,0,0,0,61
4,2,2,1,86,0,0,0,197
4,0,4,1,64,0,0,0,862
1,0,1,1,64,0,0,0,568
9,4,5,2,64,0,0,0,712
3,1,2,3,29,0,0,0,1154
436,211,225,10,1,0,0,0.0015015015015015,666
118,56,62,9,1,0,0,0,138
58,2,56,3,2,1,0,0,371
49,20,29,4,2,1,0,0,319
0,0,0,1,22,0,0,0,0
16,8,8,1,86,0,0,0,1014
20,10,10,1,86,0,0,0,1016
9,1,8,2,64,0,0,0,225
9,4,5,2,64,0,0,0,100
19,9,10,4,37,0,0,0,686
8,4,4,2,86,0,0,0,804
32,20,12,5,29,0,0,0,450
2,1,1,1,86,0,0,0,72
10,5,5,2,37,0,0,0,1386
6,1,5,2,64,0,0,0,1429
6,3,3,2,37,0,0,0,1868
1,0,1,1,64,0,0,0,993
11,9,2,3,29,0,0,0,2218
1,0,1,1,30,0,0,0,1291
9,2,7,2,37,0,0,0,347
0,0,0,1,22,0,0,0,0
33,15,18,2,68,0,0,0,955
8,4,4,1,86,0,0,0,420
6,3,3,1,37,0,0,0,243
17,9,8,3,29,0,0,0,981
4,2,2,1,86,0,0,0,133
1,0,1,1,68,0,0,0,130
31,17,14,5,46,1,0,0,448
16,8,8,1,86,0,0,0,97
4,2,2,1,86,0,0,0,199
33,15,18,4,68,0,0,0,1529
6,2,4,2,38,0,0,0,965
1,0,1,1,68,0,0,0,423
1,0,1,1,30,0,0,0,1194
156,53,103,6,32,0,0,0,822
0,0,0,1,31,0,0,0,0
0,0,0,1,31,0,0,0,0
0,0,0,1,31,0,0,0,0
0,0,0,1,31,0,0,0,0
0,0,0,1,31,0,0,0,0
0,0,0,1,31,0,0,0,0
0,0,0,1,31,0,0,0,0
0,0,0,1,31,0,0,0,0
0,0,0,1,31,0,0,0,0
0,0,0,1,31,0,0,0,0
0,0,0,1,31,0,0,0,0
0,0,0,1,31,0,0,0,0
0,0,0,1,31,0,0,0,0
0,0,0,1,31,0,0,0,0
0,0,0,1,31,0,0,0,0
0,0,0,1,31,0,0,0,0
0,0,0,1,31,0,0,0,0
0,0,0,1,31,0,0,0,0
10,5,5,3,31,0,0,0,0
0,0,0,1,31,0,0,0,0
10,5,5,3,31,0,0,0,0
0,0,0,1,31,0,0,0,0
0,0,0,1,31,0,0,0,0
0,0,0,1,31,0,0,0,0
0,0,0,1,31,0,0,0,0
0,0,0,1,31,0,0,0,0
4,2,2,2,31,0,0,0,0
0,0,0,1,31,0,0,0,0
0,0,0,1,31,0,0,0,0
0,0,0,1,31,0,0,0,0
4,2,2,2,31,0,0,0,0
0,0,0,1,31,0,0,0,0
57,41,16,3,5,0,0,0,416
96,19,77,4,32,0,0,0.000647668393782383,1544
0,0,0,1,31,0,0,0,0
0,0,0,1,31,0,0,0,0
0,0,0,1,31,0,0,0,0
0,0,0,1,31,0,0,0,0
0,0,0,1,31,0,0,0,0
0,0,0,1,31,0,0,0,0
0,0,0,1,31,0,0,0,0
0,0,0,1,31,0,0,0,0
0,0,0,1,31,0,0,0,0
0,0,0,1,31,0,0,0,0
0,0,0,1,31,0,0,0,0
0,0,0,1,31,0,0,0,0
61,18,43,6,18,2,0,0,1661
2,1,1,1,18,1,0,0,43
2,0,2,1,32,0,0,0,2212
10,5,5,1,89,0,0,0,1196
10,5,5,1,89,0,0,0,1176
10,5,5,1,89,0,0,0,1206
16,0,16,1,32,0,0,0,1682
393,126,267,7,32,0,0,0,3067
18,10,8,2,9,1,0,0,1449
2,1,1,1,37,0,0,0,377
167,75,92,6,32,0,0,0,2471
22,7,15,2,32,0,0,0,414
48,7,41,4,32,0,0,0,1190
92,46,46,1,37,0,0,0,1654
2,1,1,1,34,1,0,0,354
2,1,1,1,34,1,0,0,450
2,1,1,1,32,0,0,0,148
2,1,1,1,32,0,0,0,685
5,3,2,1,82,1,0,0,810
2,2,0,1,31,0,0,0,118
2,2,0,1,31,0,0,0,118
2,1,1,1,37,0,0,0,213
2,1,1,1,37,0,0,0,174
15,14,1,3,17,1,0,0.0032258064516129,310
0,0,0,1,32,0,0,0,0
0,0,0,1,34,1,0,0,0
2,1,1,2,32,1,0,0,324
0,0,0,1,34,1,0,0,570
0,0,0,1,34,1,0,0,280
0,0,0,1,34,1,0,0,95
2,1,1,2,32,2,0,0,554
4,2,2,3,25,2,0,0,1042
0,0,0,1,34,1,0,0,704
0,0,0,1,34,1,0,0,411
0,0,0,1,34,1,0,0,275
6,3,3,3,25,2,0,0,967
0,0,0,1,34,1,0,0,320
0,0,0,1,34,1,0,0,243
0,0,0,1,34,1,0,0,120
0,0,0,1,34,1,0,0,215
0,0,0,1,34,1,0,0,229
4,2,2,3,25,1,0,0,334
8,4,4,4,8,2,0,0,270
0,0,0,1,34,1,0,0,47
0,0,0,1,34,1,0,0,216
0,0,0,1,34,1,0,0,39
2,1,1,2,32,1,0,0,226
0,0,0,1,34,1,0,0,292
0,0,0,1,34,1,0,0,0
0,0,0,1,34,1,0,0,0
0,0,0,1,34,1,0,0,0
0,0,0,1,34,1,0,0,0
0,0,0,1,34,1,0,0,0
0,0,0,1,34,1,0,0,0
0,0,0,1,34,1,0,0,0
0,0,0,1,34,1,0,0,0
6,3,3,2,34,1,0,0,0
4,2,2,2,34,1,0,0,0
4,2,2,3,34,1,0,0,0
0,0,0,1,34,1,0,0,0
0,0,0,1,34,1,0,0,0
0,0,0,1,34,1,0,0,0
0,0,0,1,34,1,0,0,0
2,1,1,2,34,1,0,0,0
569,106,463,15,19,4,0,0,293
129,65,64,10,19,0,0,0,172
10,8,2,4,30,0,0,0,102
243,132,111,6,11,1,0,0,352
1,1,0,2,11,1,0,0,128
1021,562,459,21,17,3,0,0.00143884892086331,695
123,59,64,7,3,1,0,0.0087719298245614,114
72,64,8,5,11,1,0,0,99
108,89,19,3,45,0,0,0,4098
58,39,19,3,45,0,0,0,1252
42,26,16,3,45,0,0,0,853
142,101,41,7,25,1,0,0,7030
1908,964,944,3,45,0,0,0,2389
111,24,87,5,25,1,0,0,263
170,46,124,4,25,0,0,0,255
0,0,0,1,34,1,0,0,0
6,0,6,5,34,1,0,0,0
0,0,0,1,34,1,0,0,0
0,0,0,1,34,1,0,0,0
0,0,0,1,34,1,0,0,0
2,1,1,1,32,0,0,0,122
2,1,1,1,32,0,0,0,1332
26,19,7,6,30,1,0,0.00260756192959583,767
2,1,1,1,32,0,0,0,1664
2,1,1,1,32,0,0,0,1072
27,12,15,6,23,4,0,0.00316455696202532,316
18,11,7,4,32,0,0,0,576
180,115,65,11,32,0,0,0,1575
33,28,5,4,38,0,0,0,145
65,52,13,4,32,0,0,0,631
4,4,0,1,89,0,0,0,87
360,241,119,11,6,2,0,0.000468384074941452,2135
6,6,0,2,47,0,0,0,189
2,0,2,1,69,0,0,0,525
389,354,35,3,32,1,0,0,503
13,13,0,1,88,0,0,0,57
12,6,6,3,32,0,0,0,1133
30,16,14,4,25,1,0,0,490
24,14,10,4,86,0,0,0,147
0,0,0,1,88,0,0,0,45
161,71,90,14,32,1,0,0.00122549019607843,1632
6,1,5,1,32,0,0,0,312
3,1,2,2,32,0,0,0,1460
6,3,3,2,37,0,0,0,109
32,25,7,5,32,0,0,0,1209
101,50,51,7,5,1,0,0,636
5,2,3,2,37,0,0,0,822
2,1,1,2,32,0,0,0,0
0,0,0,1,32,0,0,0,37
537,370,167,14,32,1,0,0.000205170291341814,9748
2,1,1,1,38,0,0,0,107
6,1,5,3,32,0,0,0,317
98,89,9,3,69,0,0,0,1500
12,12,0,1,89,0,0,0,69
6966,3489,3477,6,37,1,0,0,5279
6,3,3,2,32,0,0,0,1001
6,3,3,2,37,0,0,0,154
119,93,26,19,31,1,0,0.00130890052356021,764
7,7,0,2,88,0,0,0,93
125,86,39,10,8,2,0,0.0018018018018018,2220
3,3,0,1,45,0,0,0,149
22,6,16,3,32,0,0,0,541
2,0,2,1,32,0,0,0,103
12,6,6,3,37,0,0,0.000598444045481747,1671
2,1,1,2,69,0,0,0,1158
72,48,24,6,18,0,0,0.000979431929480901,1021
6,5,1,1,53,0,0,0,94
553,400,153,14,2,1,0,0.000260314981127164,7683
12,12,0,2,88,0,0,0,74
1206,679,527,15,2,1,0,0,1409
110,29,81,3,56,0,0,0.00446428571428571,224
61,39,22,5,1,1,0,0,535
2,1,1,1,40,0,0,0,69
2,1,1,1,32,0,0,0,1104
71,37,34,6,37,2,0,0,5823
2,1,1,1,11,0,0,0,328
251,42,209,16,15,0,0,0.000931098696461825,1074
172,75,97,23,15,2,0,0.00165562913907285,604
45,18,27,2,32,0,0,0,1430
2,0,2,1,69,0,0,0,116
6,3,3,2,38,1,0,0,684
10,5,5,2,6,0,0,0,793
2,2,0,1,45,0,0,0.00775193798449612,129
61,34,27,8,24,0,0,0,1802
16,8,8,1,37,0,0,0,278
38,31,7,16,8,0,0,0,3086
17,10,7,5,31,0,0,0,870
3,0,3,1,69,0,0,0,283
3,1,2,2,53,0,0,0,272
3,1,2,2,37,0,0,0,321
27,9,18,3,32,0,0,0,577
10,10,0,1,88,0,0,0,102
44,19,25,4,32,0,0,0,564
16,4,12,1,32,0,0,0,202
4,2,2,1,32,0,0,0.00462962962962963,216
8041,4056,3985,4,32,0,0,0,5984
130,32,98,8,30,1,0,0,2050
6,0,6,1,32,0,0,0,106
6,3,3,1,63,1,0,0,99
20,10,10,4,37,0,0,0.00269905533063428,741
53,38,15,4,37,1,0,0,393
2,1,1,1,55,0,0,0,37
9,1,8,3,37,0,0,0,707
4,2,2,2,37,0,0,0,409
3,0,3,1,69,0,0,0,230
17,9,8,3,33,0,0,0,1653
8,4,4,1,37,0,0,0,574
31,25,6,5,37,0,0,0.0006265664160401,1596
2,0,2,1,69,0,0,0,356
2,1,1,1,32,0,0,0,368
14,6,8,4,38,1,0,0,883
72,56,16,6,32,2,0,0.000267881060809001,3733
2,2,0,1,45,0,0,0,265
19,9,10,5,37,0,0,0,1236
207,156,51,7,8,0,0,0.00070323488045007,1422
12,12,0,1,83,0,0,0,75
113,94,19,6,20,1,0,0,634
74,42,32,5,37,0,0,0,833
96,48,48,6,37,1,0,0,3857
43,33,10,4,32,0,0,0,1160
8,4,4,4,37,0,0,0,130
27,17,10,6,0,0,0,0,60
2,0,2,1,70,0,0,0,201
2,1,1,1,32,0,0,0,582
44,22,22,1,37,0,0,0,382
38,19,19,2,37,0,0,0,383
36,18,18,2,37,0,0,0,339
36,18,18,2,37,0,0,0,1642
14,7,7,1,37,0,0,0,751
20,10,10,2,37,0,0,0,185
17,8,9,4,37,0,0,0,217
83,53,30,6,38,1,0,0,1097
52,30,22,5,37,0,0,0,769
8,4,4,1,37,0,0,0,159
56,21,35,3,15,0,0,0,3655
48,24,24,11,15,0,0,0,1588
16,8,8,4,37,2,0,0,917
45,22,23,9,37,0,0,0.000687757909215956,1454
20,10,10,2,37,0,0,0,206
131,69,62,9,24,4,0,0.000556173526140156,1798
16,8,8,5,37,0,0,0,352
80,40,40,4,37,1,0,0,1035
40,20,20,7,37,1,0,0,750
1,1,0,1,52,0,0,0,181
16,6,10,1,82,0,0,0,213
385,214,171,7,31,0,0,0,1065
6,6,0,1,55,0,0,0,100
83,75,8,6,37,0,0,0,1187
2,2,0,1,52,0,0,0,147
10,5,5,3,37,0,0,0,165
98,60,38,7,37,2,0,0.00219298245614035,912
24,23,1,2,42,1,0,0,151
1229,640,589,9,37,2,0,0.000349162011173184,5728
4,2,2,2,82,1,0,0,209
12,12,0,1,67,0,0,0,255
8,8,0,2,67,1,0,0,302
11,9,2,1,55,1,0,0,669
104,55,49,11,31,1,0,0,2204
4,3,1,4,24,0,0,0,897
125,80,45,14,24,3,0,0.000373482726423903,5355
1,1,0,1,89,1,0,0,73
210,161,49,12,15,2,0,0.000329815303430079,3032
6,3,3,1,38,0,0,0,334
2,1,1,1,37,0,0,0,247
21,11,10,7,37,0,0,0.000374953130858643,2667
6,3,3,3,37,0,0,0,104
84,45,39,9,37,0,0,0.0032258064516129,930
11,5,6,3,37,0,0,0,133
20,10,10,4,37,0,0,0,243
30,15,15,2,31,0,0,0,883
21,13,8,1,31,0,0,0,321
73,56,17,3,31,1,0,0,1177
40,30,10,2,31,1,0,0,259
12,6,6,5,37,0,0,0,228
6,3,3,3,38,0,0,0,100
54,52,2,2,9,0,0,0,362
3,3,0,1,9,0,0,0,55
54,32,22,3,45,0,0,0,1383
0,0,0,1,85,0,0,0,0
24,13,11,4,6,0,0,0,195
163,104,59,4,61,1,0,0,277
4,3,1,1,32,0,0,0,73
2,1,1,1,54,0,0,0.013986013986014,143
11,9,2,2,46,1,0,0,158
18,5,13,3,11,0,0,0.00540540540540541,185
12,6,6,4,16,1,0,0.00420168067226891,476
31,15,16,3,52,0,0,0,275
9,2,7,4,44,1,0,0.00393700787401575,254
21,13,8,2,63,2,0,0.0103092783505155,97
48,18,30,7,44,0,0,0,224
21,11,10,2,16,0,0,0.0117647058823529,170
7,3,4,2,53,0,0,0,90
41,18,23,6,17,1,0,0.00589970501474926,339
136,85,51,12,16,3,0,0.00232828870779977,859
24,12,12,5,13,1,0,0.00454545454545455,220
57,50,7,5,37,1,0,0.00495049504950495,404
220,125,95,14,4,3,0,0.00548446069469835,547
2,2,0,3,61,0,0,0,96
0,0,0,1,87,0,0,0,35
452,228,224,24,10,7,0,0.00348128807658834,1149
0,0,0,1,31,0,0,0,0
0,0,0,1,31,0,0,0,0
147,79,68,13,11,3,0,0.00446428571428571,672
6,6,0,1,13,0,0,0.0123456790123457,81
7,1,6,3,32,0,0,0,304
38,18,20,5,18,1,0,0,174
23,12,11,4,44,0,0,0,229
29,3,26,4,37,0,0,0,148
21,21,0,1,87,0,0,0,57
11,9,2,3,37,1,0,0,269
74,40,34,7,15,1,0,0.00541516245487365,554
4,2,2,3,55,0,0,0,73
197,135,62,21,4,10,0,0.00505816894284269,1977
11,4,7,5,48,2,0,0,0
0,0,0,1,48,0,0,0,0
60,44,16,12,11,2,0,0.0106100795755968,377
20,17,3,7,16,2,0,0.00760456273764259,263
4,2,2,1,44,0,0,0,99
73,45,28,16,16,3,0,0.00139470013947001,717
9,4,5,6,39,0,0,0.0072992700729927,274
71,55,16,13,17,3,0,0.00568181818181818,352
410,131,279,11,27,1,0,0.00432900432900433,693
39,8,31,3,32,0,0,0.0153846153846154,65
68,24,44,7,13,2,0,0.00245098039215686,408
33,16,17,6,12,1,0,0.0230263157894737,304
22,16,6,3,17,1,0,0.0121951219512195,164
123,86,37,10,5,3,0,0.00748129675810474,802
4,4,0,2,31,0,0,0.0212765957446809,47
170,151,19,10,37,5,0,0.00187793427230047,1065
118,58,60,9,35,2,0,0,474
20,6,14,4,42,0,0,0,190
29,26,3,4,18,2,0,0.00657894736842105,152
54,25,29,6,11,1,0,0.00676818950930626,591
39,39,0,1,16,0,0,0.0179372197309417,223
50,9,41,1,32,0,0,0,492
32,0,32,1,32,0,0,0,242
102,1,101,2,11,0,0,0,317
64,6,58,3,32,1,0,0,331
19,7,12,5,25,1,0,0,594
8,4,4,2,60,0,0,0,160
32,16,16,3,43,1,0,0,604
20,7,13,3,32,0,0,0,222
2,1,1,1,38,0,0,0,1002
36,20,16,2,37,0,0,0,619
166,27,139,5,0,1,0,0,230
89,45,44,3,32,0,0,0,958
173,34,139,5,32,0,0,0,827
58,35,23,4,37,1,0,0,1485
98,12,86,5,32,0,0,0,824
3,1,2,2,32,0,0,0,139
97,6,91,2,32,0,0,0,245
4,0,4,1,32,0,0,0,40
20,14,6,4,37,1,0,0,277
51,6,45,3,32,0,0,0,268
19,0,19,2,25,0,0,0,402
27,0,27,1,32,0,0,0,219
6,0,6,1,32,0,0,0,37
51,10,41,2,32,0,0,0,103
7,1,6,2,32,0,0,0,37
69,22,47,3,32,0,0,0,573
96,16,80,4,25,0,0,0,570
488,87,401,13,18,2,0,0,1484
20,6,14,3,32,0,0,0,218
16,1,15,1,32,0,0,0,221
12,6,6,2,38,0,0,0,1245
23,11,12,3,43,1,0,0,709
112,71,41,5,5,1,0,0,3300
37,8,29,2,32,0,0,0,1142
50,0,50,1,32,0,0,0,929
56,6,50,2,32,0,0,0,433
4,0,4,1,32,0,0,0,55
23,6,17,3,32,1,0,0.00326797385620915,306
74,11,63,1,32,0,0,0.00377358490566038,265
158,70,88,3,32,1,0,0,248
34,13,21,2,32,0,0,0,223
48,35,13,8,37,2,0,0,487
3,1,2,2,37,0,0,0,210
53,15,38,2,32,0,0,0,487
16,8,8,1,37,0,0,0,320
37,11,26,1,32,0,0,0,343
173,0,173,1,32,0,0,0,651
4,2,2,1,37,0,0,0,188
6,3,3,2,37,1,0,0,114
17,12,5,5,37,1,0,0,569
4,2,2,1,37,0,0,0,284
20,10,10,5,37,1,0,0,564
6,3,3,1,38,0,0,0,1155
10,5,5,2,37,0,0,0,684
2,1,1,1,52,0,0,0,100
418,147,271,2,30,1,0,0,701
117,38,79,1,30,0,0,0,170
50,13,37,2,32,0,0,0,249
3,0,3,1,75,0,0,0,94
44,28,16,5,32,0,0,0.00103305785123967,968
140,76,64,9,37,3,0,0,1106
49,24,25,3,37,0,0,0,422
2,1,1,1,32,0,0,0,263
10,5,5,2,37,0,0,0,239
13,11,2,2,55,1,0,0,119
30,15,15,3,32,0,0,0,1263
2,1,1,1,37,0,0,0,290
15,7,8,3,32,0,0,0,190
4,3,1,1,60,1,0,0,169
55,26,29,4,7,1,0,0,625
116,64,52,2,53,2,0,0,283
14,7,7,3,37,0,0,0,372
10,5,5,2,37,0,0,0,662
606,488,118,5,25,0,0,0,30903
6,3,3,2,25,0,0,0,1747
14,2,12,1,86,0,0,0,238
140,46,94,7,8,1,0,0,1297
4,2,2,1,64,0,0,0,678
2,1,1,1,37,0,0,0,1203
2,1,1,2,54,2,0,0,466
2,1,1,2,54,2,0,0,512
1,0,1,1,76,0,0,0,155
42,39,3,3,4,0,0,0,0
3,3,0,2,9,0,0,0,0
