CODECHURN,LOCADDED,LOCDELETED,REVISIONS,AGE,BUGFIXES,REFACTORINGS,ERROR_DENSITY,LOC
793,413,380,17,55,4,0,0.000858369098712446,2330
159,70,89,7,75,1,0,0,509
2394,1127,1267,11,1,3,0,0.00126023944549464,1587
60,35,25,7,21,3,0,0.00119904076738609,1668
2245,1072,1173,10,1,2,0,0.00128287363694676,1559
2369,1134,1235,11,1,2,0,0.00128865979381443,1552
2172,1074,1098,10,1,2,0,0.00128783000643915,1553
2223,1072,1151,10,1,2,0,0.00128865979381443,1552
2291,1087,1204,12,1,4,0,0.00322372662798195,1551
2204,1065,1139,10,1,2,0,0.00126742712294043,1578
22,11,11,3,55,0,0,0,80
2240,1071,1169,11,0,2,0,0.00128949065119278,1551
2247,1070,1177,10,1,2,0,0.00128122998078155,1561
3752,1817,1935,13,1,3,0,0.00128617363344051,1555
2777,1366,1411,11,1,2,0,0.00130548302872063,1532
2405,1145,1260,12,0,2,0,0.00127877237851662,1564
2284,1090,1194,9,1,2,0,0.00126903553299492,1576
2165,1058,1107,10,1,2,0,0.00129198966408269,1548
2386,1146,1240,11,1,2,0,0.00127959053103007,1563
2203,1067,1136,11,0,2,0,0.00129954515919428,1539
2142,1057,1085,10,1,2,0,0.00130039011703511,1538
2242,1070,1172,11,0,2,0,0.00127713920817369,1566
2190,1055,1135,11,0,2,0,0.00130378096479791,1534
2230,1068,1162,10,1,2,0,0.00129449838187702,1545
2677,1310,1367,11,1,3,0,0.0011001100110011,1818
2189,1075,1114,10,1,2,0,0.00129032258064516,1550
244,155,89,10,1,2,0,0.00128122998078155,1561
2332,1115,1217,10,1,2,0,0.00128122998078155,1561
14,7,7,2,55,0,0,0,31
14,7,7,2,55,0,0,0,40
2143,1066,1077,10,1,2,0,0.00130208333333333,1536
29,12,17,2,75,0,0,0,48
40,21,19,2,75,0,0,0,164
121,50,71,4,32,0,0,0,147
79,50,29,3,75,1,0,0,351
120,71,49,5,68,1,0,0,709
68,36,32,3,75,0,0,0,312
35,16,19,2,75,0,0,0,536
34,16,18,2,75,0,0,0,166
409,284,125,8,33,1,0,0.00169779286926995,1178
44,23,21,2,75,0,0,0,255
25,10,15,2,75,0,0,0,60
19,8,11,2,75,0,0,0,85
40,19,21,5,32,1,0,0,236
45,23,22,3,33,1,0,0,135
25,9,16,2,75,0,0,0,230
15,5,10,2,116,0,0,0,0
1382,783,599,7,15,2,0,0.00123228589032656,1623
25,12,13,2,75,0,0,0.00236406619385343,423
33,15,18,2,75,0,0,0,261
8,5,3,2,20,0,0,0,203
417,268,149,8,32,2,0,0,477
104,43,61,3,33,0,0,0,175
58,27,31,3,33,0,0,0,253
34,16,18,2,75,0,0,0,194
38,19,19,2,75,0,0,0,238
28,13,15,2,75,0,0,0,245
23,9,14,2,75,0,0,0.00353356890459364,283
33,15,18,2,75,0,0,0,251
310,180,130,8,73,2,0,0,324
21,8,13,2,75,0,0,0,273
31,14,17,2,75,0,0,0.00384615384615385,260
21,9,12,2,75,0,0,0,137
42,24,18,4,75,1,0,0,247
32,16,16,2,75,0,0,0,141
31,14,17,2,75,0,0,0.00384615384615385,260
27,11,16,2,75,0,0,0,252
426,272,154,4,75,1,0,0.000731528895391368,1367
55,25,30,4,32,0,0,0.00383141762452107,261
25,10,15,2,75,0,0,0,257
75,43,32,3,75,0,0,0.00197628458498024,506
21,8,13,2,75,0,0,0.00332225913621262,301
21,8,13,2,75,0,0,0,79
51,25,26,4,75,2,0,0,164
19,8,11,2,75,0,0,0.00826446280991736,121
1958,1114,844,24,17,4,0,0.00318471337579618,628
43,21,22,3,75,0,0,0,183
37,18,19,2,75,0,0,0,224
21,8,13,2,75,0,0,0,148
823,532,291,14,3,7,0,0.000779727095516569,2565
27,13,14,2,75,0,0,0,160
140,65,75,6,39,1,0,0,418
52,28,24,2,75,0,0,0,283
201,114,87,8,4,2,0,0.000823723228995058,1214
353,210,143,9,61,3,0,0.000867302688638335,1153
71,39,32,3,75,1,0,0.00289017341040462,346
42,22,20,2,75,0,0,0,211
916,598,318,19,22,9,0,0.00103092783505155,1940
126,80,46,6,19,2,0,0,227
128,71,57,5,75,1,0,0,955
201,114,87,8,4,2,0,0.000823723228995058,1214
61,32,29,4,51,0,0,0,134
28,14,14,2,75,0,0,0,151
82,46,36,5,74,0,0,0.00496277915632754,403
99,54,45,5,32,1,0,0.00267379679144385,374
720,570,150,5,17,0,0,0.0010183299389002,982
215,121,94,11,4,3,0,0.000823723228995058,1214
201,114,87,8,4,2,0,0.000823723228995058,1214
201,114,87,8,4,2,0,0.000823723228995058,1214
1110,728,382,25,20,13,0,0.00102774922918808,1946
156,94,62,4,75,1,0,0,926
31,15,16,2,75,0,0,0,124
803,431,372,7,28,0,0,0.0015600624024961,1282
197,112,85,7,4,2,0,0.000823723228995058,1214
625,324,301,13,2,2,0,0.00186219739292365,1074
229,129,100,10,1,2,0,0.000821692686935086,1217
559,407,152,9,19,3,0,0.000672043010752688,1488
111,59,52,6,19,1,0,0.0101522842639594,197
61,29,32,3,75,0,0,0,105
900,496,404,17,1,4,0,0.00166251039068994,1203
24,10,14,3,51,0,0,0.0208333333333333,48
19,8,11,2,75,0,0,0.00826446280991736,121
41,20,21,3,75,1,0,0,164
44,22,22,2,75,0,0,0,232
25,12,13,2,75,0,0,0.00862068965517241,116
128,72,56,6,68,1,0,0.00303490136570561,659
37,18,19,2,75,0,0,0.00440528634361234,227
475,117,358,4,32,1,0,0.00101522842639594,985
163,96,67,5,19,1,0,0.00122850122850123,814
202,109,93,8,13,2,0,0.00136798905608755,731
21,8,13,2,75,0,0,0,48
84,42,42,3,75,0,0,0,752
36,17,19,3,75,1,0,0,101
21,8,13,2,75,0,0,0,122
8,4,4,1,84,0,0,0,63
8,4,4,1,84,0,0,0,63
79,44,35,3,75,1,0,0,279
56,31,25,3,75,1,0,0,228
19,9,10,2,75,0,0,0,134
28,14,14,2,75,0,0,0,131
83,48,35,2,75,1,0,0,121
6,3,3,2,1,0,0,0,72
6,3,3,2,19,1,0,0,47
6,3,3,2,19,1,0,0,57
2483,1318,1165,34,4,12,0,0.00125596583772921,3981
304,198,106,9,17,1,0,0.00829875518672199,241
920,731,189,12,17,3,0,0.00120192307692308,832
255,153,102,7,1,1,0,0.00317965023847377,629
760,534,226,15,17,2,0,0.00184842883548983,541
6,3,3,2,3,0,0,0,55
8,4,4,1,84,0,0,0,86
64,52,12,2,75,1,0,0,126
8,4,4,1,84,0,0,0,52
18,10,8,2,75,0,0,0,86
31,18,13,2,75,1,0,0,75
8,4,4,1,84,0,0,0,60
421,175,246,15,26,1,0,0.00512820512820513,195
21,11,10,2,75,0,0,0,57
30,13,17,1,126,0,0,0,58
36,22,14,2,75,1,0,0,74
13,6,7,1,126,0,0,0,47
8,4,4,1,84,0,0,0,45
16,9,7,2,17,1,0,0,115
37,18,19,2,75,0,0,0,130
24,10,14,2,75,0,0,0,99
24,10,14,2,75,0,0,0,98
24,10,14,2,75,0,0,0,179
58,33,25,3,75,1,0,0,184
24,10,14,2,75,0,0,0,176
26,11,15,2,75,0,0,0,103
38,19,19,2,75,0,0,0,135
59,32,27,2,75,0,0,0,94
89,58,31,4,1,1,0,0,123
55,24,31,3,2,0,0,0,118
57,26,31,4,1,0,0,0,94
49,26,23,4,1,0,0,0,122
36,19,17,3,75,1,0,0,148
75,42,33,4,68,2,0,0,213
46,27,19,4,75,1,0,0,101
224,127,97,2,75,0,0,0.00196078431372549,1020
24,13,11,2,75,0,0,0,147
61,37,24,4,88,1,0,0,289
207,93,114,4,75,0,0,0,350
42,24,18,2,75,0,0,0,341
73,40,33,4,75,1,0,0,499
316,173,143,7,9,1,0,0,243
49,26,23,3,75,1,0,0,225
98,61,37,5,33,1,0,0,232
209,139,70,8,32,1,0,0.0050251256281407,199
101,58,43,7,40,2,0,0.00348432055749129,287
365,218,147,8,75,2,0,0.00171821305841924,1746
36,18,18,2,75,0,0,0,133
150,83,67,3,75,2,0,0,760
660,320,340,10,68,4,1,0.00109170305676856,916
36,19,17,3,75,1,0,0,171
119,63,56,4,75,1,0,0,244
44,26,18,4,75,1,0,0,102
112,56,56,2,75,0,0,0.00275482093663912,363
38,20,18,2,75,0,0,0,149
220,149,71,8,15,4,0,0,428
93,42,51,3,75,1,0,0,280
171,91,80,7,75,3,0,0,557
568,327,241,9,75,3,0,0,921
196,106,90,5,25,0,0,0.00141043723554302,709
90,37,53,3,75,1,0,0,120
694,485,209,14,41,1,0,0,1184
810,477,333,26,3,9,0,0,737
550,303,247,2,1,0,0,0,613
259,134,125,11,16,3,0,0,607
877,523,354,23,0,7,0,0,792
704,414,290,20,4,6,0,0,732
882,530,352,22,3,7,0,0,810
634,385,249,19,4,5,0,0,702
218,109,109,8,68,4,0,0.00151285930408472,661
8,4,4,2,75,0,0,0,74
81,44,37,4,75,0,0,0.00645161290322581,155
55,26,29,4,75,1,0,0,100
255,143,112,12,9,6,0,0.00165425971877585,1209
167,89,78,11,42,2,0,0,364
38,19,19,3,75,0,0,0,132
501,323,178,11,32,1,0,0.000754716981132075,1325
100,48,52,2,75,0,0,0,130
81,57,24,3,68,0,0,0.00694444444444444,144
78,55,23,3,75,0,0,0,152
906,413,493,7,68,2,0,0,1532
4982,3441,1541,30,17,5,0,0,2319
1119,719,400,17,3,3,0,0,527
198,97,101,9,48,2,0,0,254
53,28,25,3,75,1,0,0,302
26,12,14,1,88,0,0,0,97
32,17,15,2,75,0,0,0,95
100,52,48,5,75,2,0,0,390
98,70,28,5,1,2,0,0,229
108,77,31,5,1,2,0,0,233
89,65,24,4,1,1,0,0,231
92,67,25,4,1,1,0,0,232
154,91,63,8,47,2,0,0,753
38,18,20,2,75,0,0,0,302
291,192,99,2,75,0,0,0,3619
225,101,124,7,32,1,0,0,223
21,8,13,2,116,0,0,0,0
2512,1345,1167,12,11,3,0,0.000884564352056612,2261
425,212,213,7,3,2,0,0.00161812297734628,618
42,19,23,3,9,1,0,0,121
99,44,55,3,75,1,0,0,214
60,33,27,3,9,1,0,0,532
36,18,18,3,9,1,0,0,84
8,4,4,1,88,0,0,0.021505376344086,93
22,11,11,2,9,1,0,0.0163934426229508,122
90,45,45,2,75,0,0,0,127
131,78,53,4,9,1,0,0.00289855072463768,345
8,4,4,1,88,0,0,0,56
59,25,34,2,75,0,0,0,92
22,10,12,2,75,0,0,0,111
164,95,69,6,2,2,0,0,328
29,13,16,3,9,1,0,0,143
244,109,135,5,68,1,0,0,308
1430,691,739,22,3,6,0,0.00181818181818182,1100
132,55,77,4,75,0,0,0,99
1010,594,416,12,33,4,0,0,631
198,85,113,3,75,1,0,0,268
182,74,108,3,75,1,0,0,257
556,275,281,6,34,3,0,0,828
193,85,108,3,75,1,0,0,273
53,32,21,4,75,1,0,0,278
426,201,225,8,68,2,0,0,443
962,593,369,15,3,4,0,0.00134003350083752,2985
530,330,200,4,22,0,1,0.00144717800289436,691
351,169,182,4,9,0,0,0.00210084033613445,476
54,30,24,3,9,0,0,0.00401606425702811,249
212,90,122,6,9,1,0,0,292
8088,3927,4161,44,1,13,0,0.00152415790275873,6561
220,128,92,9,32,0,0,0.0132450331125828,151
1863,957,906,28,29,4,0,0.00130505709624796,3065
46,24,22,4,48,0,0,0,146
121,69,52,4,0,0,0,0,290
306,137,169,5,75,0,0,0,605
326,166,160,6,75,0,0,0,659
8,4,4,1,88,0,0,0,70
8,4,4,1,88,0,0,0,60
12,5,7,1,88,0,0,0,72
5,2,3,2,67,0,0,0,59
12,6,6,1,88,0,0,0,63
8,4,4,1,88,0,0,0,66
8,4,4,1,88,0,0,0,57
0,0,0,1,29,0,0,0,68
12,6,6,1,88,0,0,0,74
4,2,2,2,67,0,0,0,54
8,4,4,1,88,0,0,0,62
386,147,239,14,39,1,0,0.00313479623824451,319
565,220,345,13,39,1,0,0.00165837479270315,603
70,33,37,4,9,0,0,0,138
63,30,33,4,9,0,0,0,132
71,34,37,5,9,0,0,0,174
29,13,16,2,75,0,0,0,96
22,10,12,2,41,1,0,0,69
12,5,7,1,88,0,0,0,57
12,5,7,1,88,0,0,0,57
455,240,215,10,75,1,0,0.00125,800
346,170,176,6,68,1,0,0,344
209,139,70,6,39,1,0,0,548
597,280,317,12,75,5,0,0,944
98,31,67,3,75,0,0,0,124
36,19,17,3,75,1,0,0,152
216,126,90,5,75,0,0,0.00221238938053097,904
234,126,108,5,17,0,0,0.00107411385606874,931
52,27,25,4,17,0,0,0,290
134,83,51,7,43,1,0,0.00285714285714286,350
84,45,39,4,75,1,0,0,231
120,58,62,3,75,0,0,0,225
80,39,41,2,75,0,0,0,270
449,217,232,10,42,1,0,0,1432
32,14,18,2,75,0,0,0,174
3,2,1,1,21,0,0,0,121
172,169,3,1,21,0,0,0,297
3,1,2,1,21,0,0,0,93
3,1,2,1,21,0,0,0,105
197,184,13,1,21,0,0,0,401
262,234,28,1,21,0,0,0,366
2,1,1,1,21,0,0,0,104
3,1,2,1,21,0,0,0,104
252,154,98,3,27,0,0,0,7871
5,3,2,1,103,0,0,0,604
6,3,3,1,85,0,0,0,541
1,1,0,1,85,0,0,0,214
27,23,4,1,103,0,0,0,337
230,190,40,1,21,0,0,0,2425
39,19,20,2,84,1,0,0,282
94,48,46,1,21,0,0,0,672
5,4,1,1,21,0,0,0,628
5,4,1,1,21,0,0,0,134
5,4,1,1,21,0,0,0,181
6,5,1,1,21,0,0,0,84
15,9,6,1,21,0,0,0,111
8,6,2,1,21,0,0,0,158
5,4,1,1,21,0,0,0,157
5,4,1,1,21,0,0,0,149
31,21,10,1,21,0,0,0,2243
17,10,7,1,21,0,0,0,63
17,10,7,1,21,0,0,0,68
33,18,15,1,21,0,0,0,196
8,6,2,1,21,0,0,0,386
148,76,72,1,21,0,0,0,916
6,4,2,1,21,0,0,0,2044
156,79,77,1,21,0,0,0,933
45,24,21,1,21,0,0,0,310
31,17,14,1,21,0,0,0,186
144,60,84,1,21,0,0,0,1042
123,63,60,1,21,0,0,0,612
68,30,38,1,21,0,0,0.0028328611898017,353
588,184,404,2,61,0,0,0,272
453,151,302,2,61,0,0,0,240
595,150,445,2,61,0,0,0,216
123,39,84,1,156,0,0,0,67
95,38,57,1,156,0,0,0,61
0,0,0,1,156,0,0,0,32
213,47,166,2,61,0,0,0,66
1262,438,824,2,61,0,0,0,635
1142,357,785,2,61,0,0,0,544
371,113,258,2,61,0,0,0,207
19,14,5,1,156,0,0,0,21
30,19,11,1,156,0,0,0,29
20,14,6,1,156,0,0,0,25
106,59,47,1,156,0,0,0,101
45,25,20,1,156,0,0,0,52
133,39,94,2,61,0,0,0,60
290,83,207,2,61,0,0,0,148
0,0,0,1,116,0,0,0,943
0,0,0,1,116,0,0,0,52
2,1,1,2,21,0,0,0,61
588,327,261,5,29,0,0,0,998
624,510,114,5,29,0,0,0,1410
417,289,128,2,12,1,0,0,364
6,3,3,1,172,0,0,0,79
35,19,16,4,9,0,0,0,141
12,6,6,2,137,0,0,0,83
31,18,13,3,4,2,0,0,116
6,3,3,1,172,0,0,0.0111111111111111,90
12,6,6,2,137,0,0,0,56
12,6,6,2,137,0,0,0,122
109,56,53,5,75,0,0,0.00448430493273543,223
62,36,26,3,75,0,0,0,219
12,6,6,2,137,0,0,0,141
4,2,2,1,172,0,0,0,61
8,4,4,2,75,0,0,0,176
28,15,13,2,75,0,0,0,155
250,9,241,3,116,0,0,0,24
6,3,3,1,172,0,0,0,61
8,4,4,1,137,0,0,0,133
25,13,12,3,75,0,0,0,263
36,21,15,3,75,0,0,0,78
44,23,21,3,75,0,0,0,161
12,6,6,2,137,0,0,0,126
6,3,3,1,172,0,0,0,47
6,3,3,1,172,0,0,0,47
12,6,6,2,75,0,0,0,141
6,3,3,1,172,0,0,0,47
87,51,36,4,75,1,0,0.00862068965517241,116
98,51,47,6,56,1,0,0,422
187,100,87,6,75,0,0,0.00156739811912226,638
24,12,12,4,126,1,0,0,67
0,0,0,1,67,0,0,0,95
26,14,12,3,19,0,0,0,105
226,113,113,6,62,0,0,0,193
981,849,132,18,1,6,0,0,832
43,20,23,3,68,0,0,0,178
2,1,1,1,116,0,0,0,192
10,5,5,3,116,0,0,0,192
16,8,8,2,64,0,0,0,377
6,3,3,1,89,0,0,0,155
35,18,17,4,75,1,0,0,191
8,4,4,1,89,0,0,0,109
71,38,33,2,75,0,0,0.00354609929078014,282
4,2,2,1,89,0,0,0,84
73,39,34,2,75,0,0,0.00446428571428571,224
4,2,2,1,89,0,0,0,40
4,2,2,1,89,0,0,0,78
24,12,12,3,43,0,0,0,119
6,3,3,2,29,0,0,0,0
6,3,3,2,29,0,0,0,0
6,3,3,2,29,0,0,0,0
6,3,3,2,29,0,0,0,0
0,0,0,1,29,0,0,0,325
4,2,2,1,89,0,0,0,53
48,23,25,3,43,0,0,0,91
32,17,15,3,9,1,0,0,168
15,8,7,2,75,0,0,0,112
40,19,21,2,75,0,0,0,181
21,10,11,3,43,0,0,0,130
6,3,3,1,89,0,0,0,263
