CODECHURN,LOCADDED,LOCDELETED,REVISIONS,AGE,BUGFIXES,REFACTORINGS,ERROR_DENSITY,LOC
2,1,1,1,105,0,0,0,0
6,3,3,2,3,0,0,0.00277392510402219,721
6,3,3,2,3,0,0,0.00292397660818713,684
0,0,0,1,3,0,0,0,0
0,0,0,1,3,0,0,0,0
0,0,0,1,2,0,0,0,0
0,0,0,1,2,0,0,0,0
6,3,3,3,107,0,0,0,0
1,1,0,1,98,0,0,0,0
21,12,9,1,100,1,0,0,0
1,1,0,1,98,0,0,0,0
2,1,1,1,100,1,0,0,0
2,1,1,1,100,1,0,0,0
2,1,1,1,14,1,0,0,0
0,0,0,1,100,0,0,0,0
1,1,0,1,34,1,0,0,0
66,64,2,8,86,0,0,0,0
125,123,2,16,4,2,0,0,0
8,6,2,1,24,1,0,0,0
2,1,1,2,5,0,0,0,0
0,0,0,1,5,0,0,0,0
6,6,0,2,5,0,0,0,0
12,6,6,2,5,0,0,0,0
0,0,0,1,5,0,0,0,0
4,2,2,2,5,0,0,0,0
92,49,43,4,6,3,0,0,0
0,0,0,1,110,1,0,0,0
0,0,0,2,110,1,0,0,0
0,0,0,1,110,1,0,0,0
0,0,0,1,110,1,0,0,0
0,0,0,1,110,1,0,0,0
0,0,0,1,110,1,0,0,0
0,0,0,1,110,1,0,0,0
0,0,0,1,110,1,0,0,0
0,0,0,2,110,1,0,0,0
0,0,0,2,110,1,0,0,0
0,0,0,2,110,1,0,0,0
0,0,0,2,110,1,0,0,0
0,0,0,2,110,1,0,0,0
24,17,7,3,34,1,0,0,0
8,5,3,4,36,1,0,0,0
2,0,2,1,39,0,0,0,0
5,5,0,1,4,0,0,0,0
89,89,0,1,41,0,0,0,0
5,4,1,1,41,0,0,0,0
116,94,22,6,18,1,0,0,0
38,5,33,2,39,0,0,0,0
0,0,0,1,39,0,0,0,0
0,0,0,1,39,0,0,0,0
25,19,6,1,41,0,0,0,0
35,32,3,3,26,2,0,0,0
2,0,2,2,37,0,0,0,0
0,0,0,2,37,0,0,0,0
2,1,1,3,37,0,0,0,0
90,58,32,9,18,3,0,0,0
16,8,8,4,24,2,0,0,0
13,7,6,3,23,0,0,0,0
306,184,122,20,14,4,0,0,0
336,234,102,13,21,3,0,0,0
210,94,116,16,21,2,0,0,0
45,27,18,5,21,0,0,0,0
189,82,107,16,21,2,0,0,0
49,49,0,3,21,0,0,0,0
248,144,104,13,21,2,0,0,0
42,21,21,3,28,0,0,0,0
40,2,38,4,34,0,0,0,0
181,69,112,14,21,2,0,0,0
121,81,40,8,3,0,0,0,0
221,101,120,16,21,2,0,0,0
79,46,33,8,21,0,0,0,0
10,5,5,3,37,0,0,0,0
1,1,0,2,37,0,0,0,0
6,0,6,2,71,0,0,0,0
10,5,5,5,28,2,0,0,0
21,17,4,4,28,0,0,0,0
4,2,2,3,96,2,0,0,0
46,44,2,4,95,1,0,0,0
16,8,8,4,95,0,0,0,0
0,0,0,1,107,0,0,0,0
0,0,0,1,107,0,0,0,0
0,0,0,1,107,0,0,0,0
0,0,0,1,107,0,0,0,0
465,78,387,7,86,0,0,0,0
77,47,30,11,10,1,0,0,0
0,0,0,1,94,0,0,0,0
244,173,71,4,87,0,0,0,0
78,39,39,3,94,0,0,0,0
60,59,1,3,87,0,0,0,0
635,468,167,10,10,1,0,0,0
14,14,0,3,105,0,0,0,0
10,10,0,3,105,0,0,0,0
6,5,1,3,98,1,0,0,0
16,13,3,6,17,0,0,0,0
2,1,1,2,107,0,0,0,0
2,1,1,2,86,0,0,0,0
0,0,0,1,107,0,0,0,0
18,14,4,3,104,0,0,0,0
0,0,0,1,107,0,0,0,0
0,0,0,1,107,0,0,0,0
41,33,8,4,98,0,0,0,0
16,7,9,3,94,0,0,0,0
0,0,0,1,107,0,0,0,0
0,0,0,1,107,0,0,0,0
11,3,8,3,99,0,0,0,0
0,0,0,2,18,1,0,0,0
0,0,0,1,106,0,0,0,0
0,0,0,1,106,0,0,0,0
0,0,0,1,107,0,0,0,0
0,0,0,1,107,0,0,0,0
0,0,0,1,100,0,0,0,0
0,0,0,1,107,0,0,0,0
2,1,1,2,95,0,0,0,0
0,0,0,1,95,0,0,0,0
57,55,2,3,105,0,0,0,0
8,7,1,3,105,1,0,0,0
0,0,0,1,107,0,0,0,0
0,0,0,1,107,0,0,0,0
0,0,0,1,107,0,0,0,0
6,3,3,2,106,0,0,0,0
29,24,5,3,18,1,0,0,0
133,112,21,3,34,1,0,0,0
15,14,1,4,34,1,0,0,0
1,1,0,2,98,0,0,0,0
454,344,110,6,74,1,0,0,0
193,68,125,21,27,2,0,0,0
60,46,14,3,100,0,0,0,0
0,0,0,1,107,0,0,0,0
2,1,1,2,107,1,0,0,0
2,2,0,2,86,0,0,0,0
386,341,45,6,55,1,0,0,0
0,0,0,1,107,0,0,0,0
525,34,491,7,99,1,0,0,0
20,11,9,3,106,0,0,0,0
266,30,236,4,106,1,0,0,0
0,0,0,1,106,0,0,0,0
2,1,1,2,107,1,0,0,0
0,0,0,1,107,0,0,0,0
68,55,13,7,95,1,0,0,0
6,4,2,4,40,0,0,0,0
0,0,0,1,106,0,0,0,0
0,0,0,1,106,0,0,0,0
0,0,0,1,106,0,0,0,0
0,0,0,1,106,0,0,0,0
0,0,0,1,106,0,0,0,0
0,0,0,1,106,0,0,0,0
0,0,0,1,106,0,0,0,0
0,0,0,1,106,0,0,0,0
0,0,0,1,106,0,0,0,0
0,0,0,1,106,0,0,0,0
0,0,0,1,106,0,0,0,0
0,0,0,1,106,0,0,0,0
0,0,0,1,106,0,0,0,0
0,0,0,1,106,0,0,0,0
0,0,0,1,106,0,0,0,0
0,0,0,1,106,0,0,0,0
0,0,0,1,106,0,0,0,0
0,0,0,1,106,0,0,0,0
0,0,0,1,106,0,0,0,0
0,0,0,1,106,0,0,0,0
0,0,0,1,106,0,0,0,0
0,0,0,1,106,0,0,0,0
0,0,0,1,106,0,0,0,0
0,0,0,1,106,0,0,0,0
0,0,0,1,106,0,0,0,0
0,0,0,1,106,0,0,0,0
0,0,0,1,106,0,0,0,0
0,0,0,1,106,0,0,0,0
0,0,0,1,106,0,0,0,0
0,0,0,1,106,0,0,0,0
0,0,0,1,106,0,0,0,0
0,0,0,1,106,0,0,0,0
0,0,0,1,106,0,0,0,0
0,0,0,1,106,0,0,0,0
0,0,0,1,106,0,0,0,0
0,0,0,1,106,0,0,0,0
0,0,0,1,106,0,0,0,0
0,0,0,1,106,0,0,0,0
0,0,0,1,106,0,0,0,0
0,0,0,1,106,0,0,0,0
0,0,0,1,106,0,0,0,0
0,0,0,1,106,0,0,0,0
0,0,0,1,106,0,0,0,0
0,0,0,1,106,0,0,0,0
0,0,0,1,106,0,0,0,0
0,0,0,1,106,0,0,0,0
0,0,0,1,106,0,0,0,0
0,0,0,1,106,0,0,0,0
0,0,0,1,106,0,0,0,0
0,0,0,1,106,0,0,0,0
0,0,0,1,106,0,0,0,0
0,0,0,1,106,0,0,0,0
0,0,0,1,106,0,0,0,0
0,0,0,1,106,0,0,0,0
0,0,0,1,106,0,0,0,0
26,13,13,2,98,0,0,0,0
10,5,5,2,98,0,0,0,0
0,0,0,1,106,0,0,0,0
0,0,0,1,106,0,0,0,0
44,22,22,2,98,0,0,0,0
4,2,2,2,98,0,0,0,0
0,0,0,1,106,0,0,0,0
0,0,0,1,106,0,0,0,0
0,0,0,1,106,0,0,0,0
0,0,0,1,106,0,0,0,0
0,0,0,1,106,0,0,0,0
0,0,0,1,106,0,0,0,0
0,0,0,1,106,0,0,0,0
0,0,0,1,106,0,0,0,0
0,0,0,1,106,0,0,0,0
0,0,0,1,106,0,0,0,0
0,0,0,1,106,0,0,0,0
24,14,10,6,7,3,0,0,0
1,0,1,1,94,0,0,0,0
5,2,3,2,94,0,0,0,0
5,2,3,2,94,0,0,0,0
1,0,1,1,94,0,0,0,0
53,41,12,8,7,4,0,0,0
34,19,15,9,8,5,0,0,0
12,6,6,4,28,2,0,0,0
0,0,0,2,106,1,0,0,0
6,3,3,1,25,0,0,0,0
83,48,35,1,116,0,0,0,0
4,2,2,1,116,0,0,0,0
88,88,0,3,81,0,0,0,0
4,4,0,2,95,0,0,0,0
7,0,7,2,95,1,0,0,0
0,0,0,2,95,0,0,0,0
0,0,0,2,95,0,0,0,0
8,8,0,4,77,0,0,0,0
69,60,9,5,75,0,0,0,0
2,1,1,2,41,0,0,0,0
94,47,47,4,5,0,0,0,0
2,1,1,2,41,0,0,0,0
102,51,51,4,5,0,0,0,0
2,1,1,2,41,0,0,0,0
46,23,23,4,5,0,0,0,0
2,1,1,2,41,0,0,0,0
42,21,21,4,5,0,0,0,0
2,1,1,2,41,0,0,0,0
34,17,17,4,5,0,0,0,0
2,1,1,2,41,0,0,0,0
255,200,55,5,2,0,0,0,0
64,57,7,3,2,0,0,0,0
14,7,7,4,5,0,0,0,0
2,1,1,2,41,0,0,0,0
330,165,165,4,5,0,0,0,0
2,1,1,2,41,0,0,0,0
196,98,98,6,5,0,0,0,0
8,4,4,4,25,0,0,0,0
262,131,131,4,5,0,0,0,0
2,1,1,2,41,0,0,0,0
274,137,137,4,5,0,0,0,0
2,1,1,2,41,0,0,0,0
218,109,109,4,5,0,0,0,0
2,1,1,2,41,0,0,0,0
232,116,116,8,5,0,0,0,0
48,24,24,6,18,0,0,0,0
144,72,72,5,5,0,0,0,0
4,2,2,3,11,0,0,0,0
126,63,63,4,5,0,0,0,0
2,1,1,2,41,0,0,0,0
0,0,0,1,41,0,0,0,0
16,6,10,3,25,0,0,0,0
10,5,5,2,25,0,0,0,0
0,0,0,1,41,0,0,0,0
0,0,0,1,41,0,0,0,0
2,1,1,2,25,0,0,0,0
201,190,11,7,2,0,0,0,0
0,0,0,1,41,0,0,0,0
0,0,0,1,41,0,0,0,0
0,0,0,1,41,0,0,0,0
0,0,0,1,41,0,0,0,0
5,3,2,3,24,0,0,0,0
4,1,3,3,25,0,0,0,0
2,1,1,2,41,0,0,0,0
2,1,1,2,41,0,0,0,0
64,32,32,3,25,0,0,0,0
10,5,5,3,25,0,0,0,0
90,45,45,4,9,0,0,0,0
12,6,6,3,25,0,0,0,0
2,1,1,2,41,0,0,0,0
2,1,1,2,41,0,0,0,0
2,1,1,2,41,0,0,0,0
2,1,1,2,41,0,0,0,0
10,5,5,3,25,0,0,0,0
2,1,1,2,41,0,0,0,0
1726,1562,164,9,2,0,0,0,0
24,22,2,5,2,0,0,0,0
2,1,1,2,41,0,0,0,0
2,1,1,2,41,0,0,0,0
6,3,3,3,25,0,0,0,0
4,2,2,3,25,0,0,0,0
36,18,18,3,9,0,0,0,0
2,1,1,2,41,0,0,0,0
6,3,3,3,25,0,0,0,0
4,2,2,3,25,0,0,0,0
18,9,9,3,25,0,0,0,0
6,3,3,3,25,0,0,0,0
14,7,7,3,25,0,0,0,0
4,2,2,3,25,0,0,0,0
455,322,133,5,9,0,0,0,0
6,3,3,4,25,0,0,0,0
6,3,3,3,27,0,0,0,0
2,1,1,2,41,0,0,0,0
8,4,4,3,9,0,0,0,0
2,1,1,2,41,0,0,0,0
18,9,9,4,9,0,0,0,0
10,5,5,3,25,0,0,0,0
2,1,1,2,41,0,0,0,0
2,1,1,2,41,0,0,0,0
913,809,104,10,9,0,0,0,0
34,31,3,9,17,0,0,0,0
91,81,10,3,11,0,0,0,0
3,2,1,3,11,0,0,0,0
2,1,1,2,41,0,0,0,0
2,1,1,2,41,0,0,0,0
2,1,1,2,41,0,0,0,0
2,1,1,2,41,0,0,0,0
71,43,28,4,25,0,0,0,0
0,0,0,1,41,0,0,0,0
2,0,2,2,41,0,0,0,0
6,3,3,2,25,0,0,0,0
0,0,0,1,27,1,0,0,0
227,202,25,5,4,0,0,0,0
26,25,1,3,5,0,0,0,0
111,98,13,5,4,0,0,0,0
14,13,1,3,5,0,0,0,0
133,121,12,5,4,0,0,0,0
13,12,1,3,5,0,0,0,0
107,97,10,5,4,0,0,0,0
11,10,1,3,5,0,0,0,0
391,365,26,6,2,0,0,0,0
29,28,1,4,2,0,0,0,0
41,36,5,5,4,0,0,0,0
6,5,1,3,5,0,0,0,0
932,848,84,5,4,0,0,0,0
85,84,1,3,5,0,0,0,0
731,682,49,5,4,0,0,0,0
50,49,1,3,5,0,0,0,0
575,508,67,5,4,0,0,0,0
68,67,1,3,5,0,0,0,0
925,855,70,5,4,0,0,0,0
71,70,1,3,5,0,0,0,0
604,548,56,5,4,0,0,0,0
57,56,1,3,5,0,0,0,0
657,610,47,6,4,0,0,0,0
47,46,1,3,5,0,0,0,0
435,398,37,5,4,0,0,0,0
38,37,1,3,5,0,0,0,0
348,315,33,5,4,0,0,0,0
34,33,1,3,5,0,0,0,0
0,0,0,1,41,0,0,0,0
230,192,38,7,17,0,0,0,0
0,0,0,1,41,0,0,0,0
10,8,2,2,11,0,0,0,0
2,0,2,2,41,0,0,0,0
0,0,0,1,41,0,0,0,0
0,0,0,1,103,0,0,0,0
19,13,6,8,0,1,0,0,0
59,50,9,6,0,2,0,0,0
5,2,3,3,26,2,0,0,0
8,5,3,2,99,1,0,0,0
0,0,0,1,104,0,0,0,0
0,0,0,1,100,0,0,0,0
18,10,8,3,99,2,0,0,0
0,0,0,1,101,0,0,0,0
16,8,8,2,25,0,0,0,0
9,0,9,2,98,0,0,0,0
1,1,0,2,61,0,0,0,0
0,0,0,1,81,0,0,0,0
0,0,0,1,98,0,0,0,0
274,264,10,4,25,0,0,0,0
2,2,0,2,73,1,0,0,0
0,0,0,1,73,0,0,0,0
0,0,0,1,17,0,0,0,0
0,0,0,1,17,0,0,0,0
2,0,2,2,98,0,0,0,0
1,1,0,2,98,0,0,0,0
0,0,0,1,98,0,0,0,0
0,0,0,1,98,0,0,0,0
131,110,21,5,37,0,0,0,0
90,53,37,6,17,1,0,0,0
0,0,0,1,89,0,0,0,0
0,0,0,2,41,0,0,0,0
27,5,22,4,98,1,0,0,0
0,0,0,1,41,0,0,0,0
0,0,0,1,41,0,0,0,0
0,0,0,1,41,0,0,0,0
186,12,174,7,4,0,0,0,0
0,0,0,1,41,0,0,0,0
0,0,0,1,41,0,0,0,0
0,0,0,1,41,0,0,0,0
0,0,0,1,41,0,0,0,0
0,0,0,1,41,0,0,0,0
0,0,0,1,41,0,0,0,0
0,0,0,1,41,0,0,0,0
0,0,0,1,41,0,0,0,0
0,0,0,1,41,0,0,0,0
2,1,1,2,7,0,0,0,0
11,9,2,3,3,2,0,0,0
29,18,11,5,11,3,0,0,0
0,0,0,1,41,0,0,0,0
30,30,0,2,31,0,0,0,0
37,37,0,2,31,0,0,0,0
0,0,0,1,41,0,0,0,0
0,0,0,1,41,0,0,0,0
0,0,0,1,41,0,0,0,0
0,0,0,1,41,0,0,0,0
0,0,0,1,41,0,0,0,0
0,0,0,1,41,0,0,0,0
0,0,0,1,41,0,0,0,0
0,0,0,1,41,0,0,0,0
0,0,0,1,41,0,0,0,0
6,3,3,2,40,1,0,0,0
0,0,0,1,41,0,0,0,0
0,0,0,1,41,0,0,0,0
0,0,0,1,41,0,0,0,0
9,7,2,2,41,1,0,0,0
3,3,0,2,41,1,0,0,0
36,4,32,5,4,0,0,0,0
0,0,0,1,41,0,0,0,0
17,9,8,1,5,0,0,0,107
7,5,2,2,5,1,0,0,35
10,8,2,1,35,0,0,0,0
3,1,2,3,9,0,0,0,0
4,2,2,4,9,0,0,0,0
21,17,4,3,35,0,0,0,0
17,12,5,4,5,0,0,0,0
153,108,45,6,4,1,0,0,0
18,13,5,2,41,0,0,0,0
7,6,1,1,41,0,0,0,0
6,5,1,1,41,0,0,0,0
0,0,0,1,45,0,0,0,0
8,8,0,2,24,1,0,0,0
38,23,15,5,9,1,0,0,0
15,9,6,2,85,1,0,0,0
371,193,178,21,4,5,0,0,0
0,0,0,1,41,0,0,0,0
38,28,10,2,9,0,0,0,0
0,0,0,1,45,0,0,0,0
0,0,0,1,110,1,0,0,0
1,1,0,1,34,1,0,0,0
0,0,0,1,90,0,0,0,0
2,1,1,1,99,1,0,0,0
80,46,34,11,5,2,0,0,0
2,1,1,1,95,0,0,0,0
50,32,18,5,5,0,0,0,0
20,10,10,2,81,0,0,0.00181818181818182,550
18,9,9,1,6,1,0,0,130
65,65,0,1,115,0,0,0,542
2,1,1,1,107,0,0,0.00444444444444444,450
2,1,1,1,95,0,0,0,466
4,2,2,2,6,2,0,0.0023084025854109,2166
4,3,1,1,7,1,0,0.00112612612612613,888
12,7,5,3,73,0,0,0,558
18,15,3,2,25,0,0,0,68
281,160,121,15,11,6,0,0.000999800039992002,5001
45,26,19,2,26,1,0,0.0020746887966805,1928
425,237,188,6,45,4,0,0.0019893899204244,1508
0,0,0,1,81,0,0,0,38
0,0,0,1,81,0,0,0,219
11,7,4,2,0,0,0,0.0016025641025641,624
22,3,19,1,81,0,0,0.00540540540540541,370
25,2,23,1,18,0,0,0,104
13,7,6,1,4,0,0,0.00123762376237624,808
71,27,44,4,5,0,0,0.00424929178470255,706
1,0,1,1,96,1,0,0,429
17,0,17,2,96,0,0,0,71
41,32,9,6,3,0,0,0,137
15,11,4,6,38,0,0,0,62
32,19,13,4,2,1,0,0,45
22,11,11,1,6,1,0,0,148
0,0,0,1,106,0,0,0,176
79,66,13,6,4,0,0,0.00778210116731518,257
0,0,0,1,96,0,0,0,3
8,4,4,2,12,1,0,0,77
6,6,0,2,40,0,0,0.010989010989011,91
0,0,0,1,101,0,0,0,0
12,7,5,1,107,0,0,0,240
0,0,0,1,107,0,0,0,113
0,0,0,1,95,0,0,0,303
17,8,9,1,18,0,0,0,89
86,53,33,5,21,0,0,0,66
0,0,0,1,68,0,0,0,0
6,4,2,2,93,1,0,0,39
12,0,12,5,4,0,0,0,82
416,88,328,45,0,1,0,0.00681302043906132,1321
28,12,16,3,10,3,0,0.0056390977443609,532
25,23,2,2,9,1,0,0.00105633802816901,2840
0,0,0,1,88,0,0,0,6
8,3,5,2,5,0,0,0,153
1,1,0,1,104,1,0,0,36
8,0,8,1,100,0,0,0,75
4,2,2,1,104,0,0,0,617
0,0,0,1,104,0,0,0,1
10,6,4,1,56,0,0,0,102
1,0,1,1,19,0,0,0,485
0,0,0,1,95,0,0,0,115
105,18,87,6,19,1,0,0.00265957446808511,376
0,0,0,1,95,0,0,0,571
6,2,4,2,57,1,0,0,175
26,13,13,1,104,0,0,0,91
10,6,4,2,37,0,0,0,83
22,10,12,3,41,0,0,0,397
5541,675,4866,229,0,24,3,0.0011443829868396,10486
0,0,0,1,106,0,0,0,132
4,2,2,2,9,0,0,0,74
23,0,23,1,68,0,0,0,123
1,1,0,1,101,0,0,0,60
33,0,33,3,68,0,0,0,69
259,0,259,8,87,0,0,0,322
413,107,306,11,27,3,0,0,2224
212,1,211,15,17,0,0,0,233
12,6,6,1,0,0,0,0,226
8,6,2,3,18,0,0,0,0
120,71,49,27,3,2,0,0.00263019463440295,1901
70,7,63,8,3,0,0,0.00263157894736842,380
12,8,4,2,0,0,0,0,866
25,21,4,2,96,0,0,0,64
15,4,11,3,85,0,0,0,37
20,10,10,1,104,0,0,0,75
0,0,0,1,95,0,0,0,56
42,16,26,3,7,0,0,0,108
71,56,15,11,0,0,0,0.00142247510668563,703
37,23,14,8,0,1,0,0.00497512437810945,402
0,0,0,1,106,0,0,0,48
6,3,3,1,106,0,0,0,246
8,4,4,2,95,0,0,0,415
190,178,12,7,3,0,0,0,173
367,193,174,10,2,2,0,0,674
64,51,13,2,16,2,0,0.00151898734177215,1975
120,74,46,6,12,1,0,0,1268
0,0,0,1,106,0,0,0,180
34,26,8,1,40,0,0,0.00675675675675676,148
12,10,2,2,40,0,0,0.000812347684809098,1231
2,1,1,1,100,0,0,0,410
2,1,1,1,106,0,0,0.00256410256410256,390
15,12,3,2,40,0,0,0,358
4,2,2,1,40,1,0,0,309
28,18,10,6,43,2,0,0.000907441016333938,1102
12,6,6,3,43,0,0,0,317
28,16,12,2,7,1,0,0,122
15,15,0,1,115,0,0,0,73
136,136,0,1,111,0,0,0,266
607,244,363,12,6,0,0,0.00251256281407035,398
38,32,6,3,11,2,0,0.00803212851405622,249
20,10,10,2,104,0,0,0,157
170,84,86,1,7,1,0,0,506
10,3,7,3,95,0,0,0,223
55,29,26,3,55,1,0,0.00346620450606586,577
41,22,19,3,3,1,0,0,1133
2,1,1,1,5,0,0,0,459
7,3,4,2,5,0,0,0,123
21,5,16,3,5,1,0,0,1560
2,1,1,1,5,0,0,0,1337
59,13,46,2,5,0,0,0,425
44,10,34,2,5,0,0,0,239
23,9,14,2,5,0,0,0,629
13,6,7,1,25,0,0,0,119
6,3,3,2,5,1,0,0,118
4,2,2,2,5,0,0,0,330
12,6,6,1,25,0,0,0,119
12,5,7,2,5,0,0,0,409
81,50,31,5,72,2,0,0,436
14,11,3,1,12,0,0,0.00275482093663912,363
105,67,38,2,5,0,0,0,436
16,8,8,1,86,0,0,0,166
11,5,6,4,4,1,0,0.0101010101010101,198
16,16,0,1,87,0,0,0,128
21,2,19,2,8,1,0,0,290
10,4,6,2,8,1,0,0,172
58,2,56,3,8,1,0,0.00118273211117682,1691
34,10,24,1,8,0,0,0,501
41,2,39,2,8,1,0,0.000736377025036819,1358
612,612,0,1,87,0,0,0,1840
1,0,1,1,8,0,0,0,87
278,271,7,2,8,0,0,0.00555555555555556,360
33,2,31,2,8,1,0,0,556
2,2,0,1,87,0,0,0,59
5,5,0,1,87,0,0,0,102
22,12,10,1,98,1,0,0,145
233,225,8,2,95,1,0,0,286
6,3,3,1,98,1,0,0,226
0,0,0,1,87,0,0,0,0
8,4,4,1,98,1,0,0,232
24,14,10,2,94,1,0,0,458
159,54,105,6,8,4,0,0.00114678899082569,3488
66,38,28,3,37,0,0,0,257
2,1,1,1,95,0,0,0,147
91,64,27,5,11,3,0,0,555
0,0,0,1,106,0,0,0,422
22,21,1,3,89,2,0,0,201
69,43,26,3,19,2,0,0,233
6,3,3,2,25,0,0,0,293
266,177,89,9,25,1,1,0,620
4,2,2,2,104,0,0,0.00520833333333333,192
20,14,6,2,13,2,0,0,461
23,13,10,5,25,0,0,0,404
0,0,0,1,106,0,0,0,138
75,46,29,7,5,0,0,0,388
23,3,20,6,5,0,0,0,114
24,12,12,6,5,1,0,0,95
0,0,0,1,5,0,0,0,0
2,2,0,3,5,0,0,0,85
77,50,27,6,5,0,0,0.00174216027874564,1148
0,0,0,1,5,0,0,0,0
28,21,7,6,5,0,0,0,641
0,0,0,2,5,0,0,0,0
4,2,2,2,5,0,0,0,151
67,52,15,3,5,0,0,0.00353356890459364,283
21,7,14,3,21,0,0,0.00110071546505228,1817
4,2,2,1,86,0,0,0.00293255131964809,341
5,2,3,2,6,1,0,0,915
6,3,3,1,106,0,0,0,547
16,8,8,1,104,0,0,0,346
48,24,24,1,104,0,0,0,568
16,8,8,1,104,0,0,0,336
188,25,163,11,35,0,0,0.00198649185538339,2517
0,0,0,1,95,0,0,0,130
604,28,576,4,3,1,0,0.00199335548172757,1505
0,0,0,1,100,0,0,0,770
794,255,539,18,0,2,0,0.000570776255707763,3504
352,7,345,1,106,0,0,0.00235849056603774,424
36,17,19,5,73,0,0,0,87
382,154,228,5,84,0,0,0.00350877192982456,285
17,14,3,2,25,0,0,0,762
1022,445,577,15,8,1,0,0.00137994480220791,2174
389,21,368,7,43,0,0,0,2897
381,8,373,4,7,1,0,0,1481
78,0,78,3,104,0,0,0,131
2,1,1,1,11,1,0,0,38
187,8,179,3,8,0,0,0,0
29,6,23,2,8,0,0,0,0
4,2,2,1,95,0,0,0,361
0,0,0,1,107,0,0,0,432
2,1,1,1,3,1,0,0.00186915887850467,535
1,1,0,1,114,1,0,0,530
4,2,2,1,115,0,0,0,422
11,8,3,1,34,1,0,0,188
71,68,3,4,98,0,0,0,563
214,113,101,5,32,1,0,0,289
8,4,4,1,104,0,0,0,237
70,31,39,4,10,0,0,0.00098135426889107,1019
27,21,6,2,34,1,0,0,792
160,134,26,2,11,1,0,0.0033955857385399,589
127,73,54,5,23,2,0,0,828
183,125,58,13,10,7,0,0.000771010023130301,3891
34,26,8,3,34,1,0,0.0051150895140665,391
5,4,1,1,34,1,0,0,130
1,0,1,1,96,1,0,0,117
6,3,3,1,96,0,0,0,1127
16,13,3,3,34,2,0,0,123
2,1,1,1,86,0,0,0,746
8,4,4,2,86,1,0,0.0015552099533437,643
2,1,1,1,86,0,0,0.00451467268623025,443
2,1,1,1,103,1,0,0.00749063670411985,267
4,2,2,1,10,0,0,0,187
4,2,2,1,106,0,0,0.00408163265306122,245
6,3,3,1,81,0,0,0.00115473441108545,866
34,17,17,2,86,0,0,0.000991080277502478,1009
17,12,5,2,101,2,0,0.00138888888888889,720
1,1,0,1,66,0,0,0,57
111,39,72,1,69,0,0,0,608
161,158,3,4,65,0,0,0,0
212,162,50,14,11,5,0,0.000964320154291225,2074
35,34,1,2,46,1,0,0,437
9,8,1,2,69,0,0,0,85
345,247,98,9,48,2,2,0.00178571428571429,560
69,41,28,6,69,0,0,0,86
36,19,17,6,69,1,1,0,305
244,176,68,9,69,1,1,0.0033112582781457,302
149,102,47,6,34,2,1,0.00233644859813084,1284
37,20,17,6,69,2,1,0,792
0,0,0,1,41,0,0,0,1099
0,0,0,1,41,0,0,0,138
0,0,0,1,41,0,0,0,1167
0,0,0,1,41,0,0,0,144
0,0,0,1,41,0,0,0,465
0,0,0,1,41,0,0,0,39
0,0,0,1,41,0,0,0,410
0,0,0,1,41,0,0,0,43
0,0,0,1,41,0,0,0,347
0,0,0,1,41,0,0,0,44
8,4,4,2,41,0,0,0,915
4,2,2,2,41,0,0,0,73
20,10,10,3,41,0,0,0,155
12,6,6,3,41,0,0,0,25
70,52,18,3,41,0,0,0,3401
39,28,11,3,41,0,0,0,370
84,49,35,8,41,0,0,0,2338
59,34,25,8,41,0,0,0,361
59,34,25,5,41,0,0,0,2735
26,15,11,5,41,0,0,0,225
8,4,4,3,41,0,0,0,2962
8,4,4,3,41,0,0,0,389
33,12,21,2,41,0,0,0,2641
15,6,9,2,41,0,0,0,347
44,22,22,4,41,0,0,0,2245
40,20,20,4,41,0,0,0,336
36,18,18,6,41,0,0,0,1726
20,10,10,6,41,0,0,0,229
0,0,0,1,41,0,0,0,1570
0,0,0,1,41,0,0,0,230
0,0,0,1,41,0,0,0,581
0,0,0,2,41,0,0,0,0
189,148,41,2,41,0,0,0,427
34,21,13,3,41,0,0,0,1762
0,0,0,1,41,0,0,0,211
0,0,0,1,41,0,0,0,213
4,3,1,2,41,0,0,0,354
4,2,2,2,41,0,0,0,287
23,6,17,3,41,0,0,0,64
25,19,6,3,41,1,0,0,137
613,613,0,1,87,0,0,0,1459
213,175,38,6,41,0,0,0,1647
44,8,36,5,41,0,0,0,76
0,0,0,2,41,0,0,0,0
2,1,1,2,41,1,0,0,694
0,0,0,1,41,0,0,0,5802
0,0,0,1,41,0,0,0,132
0,0,0,2,41,0,0,0,0
1367,1050,317,3,41,0,0,0,3534
50,38,12,2,41,0,0,0,133
351,162,189,3,41,0,0,0,14559
12,11,1,3,41,0,0,0,291
0,0,0,1,41,0,0,0,1082
0,0,0,1,41,0,0,0,58
0,0,0,1,41,0,0,0,1513
0,0,0,1,41,0,0,0,58
20,8,12,2,41,0,0,0,2699
0,0,0,1,41,0,0,0,76
43,34,9,2,41,0,0,0,1730
1,1,0,2,41,0,0,0,91
136,18,118,3,41,0,0,0,429
4,0,4,2,41,0,0,0,28
136,114,22,3,41,1,0,0,892
8,7,1,2,41,0,0,0,55
3623,3623,0,2,4,0,0,0,3983
297,297,0,1,87,0,0,0,393
948,819,129,3,41,0,0,0,12547
21,19,2,3,41,0,0,0,383
55,2,53,3,41,0,0,0,185
6,0,6,2,41,0,0,0,29
0,0,0,2,41,0,0,0,0
0,0,0,2,41,0,0,0,0
6,3,3,2,41,1,0,0,3364
0,0,0,1,41,0,0,0,104
1755,1425,330,11,41,1,0,0,15334
34,27,7,6,41,0,0,0,268
3,1,2,2,41,0,0,0,240
365,243,122,7,41,0,0,0,3769
0,0,0,1,41,0,0,0,211
358,256,102,8,41,0,0,0,12757
13,10,3,4,41,0,0,0,342
80,43,37,6,41,0,0,0,1007
15,14,1,6,41,0,0,0,47
419,226,193,4,41,0,0,0,19654
7,7,0,3,41,0,0,0,315
454,394,60,5,41,0,0,0,6308
5,5,0,3,41,0,0,0,159
311,132,179,7,41,0,0,0,4542
34,33,1,4,41,0,0,0,132
0,0,0,1,41,0,0,0,10679
0,0,0,1,41,0,0,0,175
540,493,47,3,41,1,0,0,327
23,17,6,3,41,1,0,0,23
232,178,54,11,41,1,0,0,1635
3,1,2,2,41,0,0,0,35
45,27,18,5,41,0,0,0,582
124,96,28,13,41,0,0,0,1784
39,33,6,7,41,0,0,0,327
46,23,23,2,41,0,0,0,1754
0,0,0,1,41,0,0,0,29
22,11,11,2,41,0,0,0,845
0,0,0,1,41,0,0,0,17
20,10,10,2,41,0,0,0,805
0,0,0,1,41,0,0,0,16
16,8,8,2,41,0,0,0,646
0,0,0,1,41,0,0,0,14
48,24,24,2,41,0,0,0,1842
0,0,0,1,41,0,0,0,30
6,3,3,2,41,0,0,0,246
0,0,0,1,41,0,0,0,9
206,110,96,4,41,0,0,0,6375
0,0,0,1,41,0,0,0,88
160,95,65,7,41,0,0,0,3866
4,2,2,3,41,0,0,0,53
150,79,71,5,41,0,0,0,4869
0,0,0,1,41,0,0,0,71
142,71,71,4,41,0,0,0,5482
0,0,0,1,41,0,0,0,74
137,67,70,4,41,0,0,0,4199
0,0,0,1,41,0,0,0,60
112,53,59,5,41,0,0,0,3621
0,0,0,1,41,0,0,0,50
74,37,37,4,41,0,0,0,2772
0,0,0,1,41,0,0,0,41
68,34,34,3,41,0,0,0,2412
0,0,0,1,41,0,0,0,37
51,32,19,4,41,0,0,0,1793
83,56,27,6,41,0,0,0,793
330,330,0,5,41,0,0,0,0
41,20,21,7,41,0,0,0,624
0,0,0,1,41,0,0,0,981
69,63,6,3,41,1,0,0,34
17,0,17,2,103,0,0,0,86
201,181,20,4,103,1,0,0,354
283,144,139,4,104,0,0,0,1101
27,0,27,3,105,0,0,0,859
6,3,3,2,104,0,0,0,293
0,0,0,1,104,0,0,0,51
176,175,1,2,101,0,0,0,177
0,0,0,1,101,0,0,0,35
9,4,5,2,104,0,0,0,141
70,12,58,3,105,0,0,0,94
0,0,0,1,80,0,0,0,35
0,0,0,1,80,0,0,0,148
71,15,56,2,105,1,0,0,738
277,53,224,2,45,0,0,0,230
23,7,16,6,25,0,0,0,0
2,1,1,2,105,0,0,0,227
0,0,0,1,106,0,0,0,709
11,9,2,3,9,0,0,0,180
50,49,1,2,5,0,0,0,75
0,0,0,1,104,0,0,0,1438
0,0,0,1,95,0,0,0,89
14,3,11,2,95,0,0,0,453
0,0,0,1,96,0,0,0,603
373,257,116,14,23,3,1,0.00806451612903226,496
857,581,276,21,0,2,0,0.00147783251231527,2030
139,69,70,8,0,1,0,0.00088809946714032,1126
38,21,17,3,54,0,0,0,312
62,26,36,5,1,1,0,0.00301659125188537,663
140,2,138,1,111,0,0,0,361
190,165,25,9,0,2,0,0.00186915887850467,2140
6,4,2,1,0,0,0,0.00150602409638554,664
357,319,38,6,7,1,0,0.000520020800832033,1923
1435,718,717,5,0,4,0,0,684
94,45,49,3,25,1,0,0.00155763239875389,642
29,4,25,2,0,0,0,0.00158856235107228,1259
549,484,65,8,8,0,0,0.00280898876404494,712
569,307,262,4,95,1,0,0,600
12,6,6,1,0,0,0,0,94
39,13,26,4,0,0,0,0.00284495021337127,703
0,0,0,1,89,0,0,0,55
34,14,20,4,86,0,0,0,202
77,59,18,6,66,3,0,0.000816993464052288,1224
23,15,8,4,9,2,0,0.00154798761609907,646
23,10,13,3,10,2,0,0.00102722136620442,1947
6,3,3,1,94,0,0,0.00231481481481481,864
10,5,5,2,10,2,0,0,400
101,82,19,4,0,1,0,0,761
30,28,2,2,9,1,0,0.00107411385606874,931
10,5,5,3,32,1,0,0.000430292598967298,2324
21,0,21,1,4,0,0,0,394
123,97,26,4,55,0,0,0.00135379061371841,2216
6,3,3,2,55,0,0,0,247
8,0,8,1,43,0,0,0,1400
5,3,2,2,77,0,0,0,759
65,36,29,2,86,0,0,0,463
141,68,73,2,57,1,0,0.00159872102318145,1251
88,57,31,2,0,1,0,0,283
3,2,1,2,10,0,0,0,258
7,7,0,1,52,1,0,0.00198412698412698,504
43,25,18,2,25,1,0,0.00192307692307692,520
2,1,1,1,106,1,0,0,420
2,1,1,1,106,0,0,0,898
93,52,41,4,95,2,0,0,346
5,2,3,1,99,0,0,0,185
0,0,0,1,88,0,0,0,3
77,21,56,3,40,2,0,0.0040650406504065,1476
45,22,23,2,34,1,0,0,1308
1397,880,517,1,42,1,0,0,2458
207,115,92,8,47,2,0,0,259
98,42,56,3,4,1,0,0.006426735218509,778
2,1,1,1,70,1,0,0,150
162,137,25,7,0,1,0,0,0
363,257,106,4,18,1,0,0,0
0,0,0,1,0,0,0,0,0
1529,834,695,7,26,3,1,0,0
145,96,49,5,0,1,0,0,0
13,7,6,3,18,1,0,0,0
259,154,105,10,11,3,0,0.00335946248600224,893
911,629,282,24,33,7,0,0.00293685756240822,681
16,7,9,2,109,0,0,0.00092678405931418,1079
9,3,6,2,4,0,0,0.00137551581843191,727
6,2,4,2,4,1,0,0,532
15,8,7,3,3,0,0,0,624
9,5,4,2,3,0,0,0,374
158,129,29,19,0,2,0,0.00314465408805031,1590
4,2,2,2,118,0,0,0,215
145,86,59,1,5,1,0,0.0027027027027027,370
8,7,1,1,12,0,0,0.00340136054421769,294
153,132,21,11,0,2,0,0.000447027268663388,2237
552,304,248,12,47,4,0,0.00321543408360129,933
10,7,3,2,26,1,0,0.0022883295194508,437
185,172,13,9,0,1,0,0,0
2,1,1,1,53,1,0,0,220
13,13,0,1,70,1,0,0,110
23,15,8,2,3,1,0,0.00164203612479475,609
4,2,2,1,4,0,0,0,249
6,3,3,2,3,0,0,0.00317965023847377,629
600,332,268,10,23,2,0,0,428
165,139,26,9,0,4,0,0.00397877984084881,754
494,389,105,10,0,4,0,0.00205973223480947,971
2,1,1,1,56,1,0,0.00252525252525253,396
79,42,37,3,11,0,0,0.00131752305665349,759
93,88,5,3,70,1,0,0,315
15,2,13,2,3,0,0,0,366
159,82,77,9,3,2,0,0.00100603621730382,994
4,2,2,1,7,1,0,0,586
3,2,1,1,95,0,0,0,252
26,8,18,3,3,0,0,0.000505816894284269,1977
7,3,4,3,21,0,0,0.00144092219020173,694
4,2,2,1,95,0,0,0,586
11,2,9,2,7,1,0,0,431
2,1,1,1,95,0,0,0.0025706940874036,389
7,2,5,2,0,0,0,0,325
30,15,15,5,11,0,0,0,2568
0,0,0,1,41,0,0,0,46
0,0,0,1,41,0,0,0,45
18,2,16,3,41,0,0,0,118
285,165,120,4,41,0,0,0,569
317,230,87,6,41,1,0,0,1112
317,225,92,6,41,1,0,0,646
121,58,63,5,41,1,0,0,717
78,7,71,2,41,0,0,0,736
10,2,8,3,41,0,0,0,165
618,597,21,12,41,0,0,0,735
0,0,0,1,41,0,0,0,32
471,262,209,11,41,3,0,0,3204
15,14,1,2,41,0,0,0,177
2,1,1,2,41,0,0,0,690
227,220,7,6,41,0,0,0,1984
0,0,0,1,41,0,0,0,30
39,18,21,2,41,0,0,0,411
0,0,0,1,41,0,0,0,76
0,0,0,1,41,0,0,0,1077
0,0,0,1,41,0,0,0,69
0,0,0,1,41,0,0,0,79
0,0,0,1,41,0,0,0,137
1,0,1,2,41,0,0,0,634
0,0,0,1,41,0,0,0,42
0,0,0,1,41,0,0,0,1477
0,0,0,1,41,0,0,0,29
0,0,0,1,41,0,0,0,442
0,0,0,1,41,0,0,0,40
0,0,0,1,41,0,0,0,659
0,0,0,1,41,0,0,0,88
12,9,3,4,41,1,0,0,489
64,48,16,3,41,1,0,0,447
316,208,108,27,11,8,0,0.000630384534566085,9518
4,2,2,2,100,0,0,0,590
2,1,1,1,100,1,0,0,0
12,6,6,2,10,1,0,0,187
24,12,12,2,25,0,0,0.00133244503664224,1501
6,3,3,1,106,0,0,0,248
787,741,46,5,34,1,0,0.000850340136054422,2352
50,32,18,5,7,3,0,0.000959232613908873,2085
57,31,26,4,4,3,0,0.00125176028790487,6391
2,1,1,1,12,1,0,0.000582072176949942,1718
788,62,726,2,42,0,0,0.00615384615384615,975
6,3,3,2,95,0,0,0,1366
2,1,1,1,81,0,0,0,105
2,1,1,1,108,1,0,0,64
51,40,11,4,5,1,0,0.00167785234899329,596
434,237,197,23,10,2,0,0.000678771423723061,5893
81,52,29,3,99,2,0,0,286
8,4,4,1,99,0,0,0,123
675,550,125,11,21,4,0,0.000557724484104852,1793
12,7,5,3,34,1,0,0,303
8,4,4,1,106,0,0,0,127
34,12,22,4,27,2,0,0.00900900900900901,111
136,89,47,7,5,2,0,0.00137174211248285,2916
2,1,1,1,10,0,0,0,215
0,0,0,1,99,0,0,0,0
4,2,2,2,25,0,0,0.000801924619085806,1247
2,1,1,1,86,0,0,0.003147128245476,1271
13,5,8,2,87,0,0,0,242
4,2,2,1,86,0,0,0,55
4,2,2,1,86,0,0,0,104
12,6,6,2,101,0,0,0.000728862973760933,1372
4,2,2,1,25,0,0,0.000522193211488251,1915
52,20,32,1,49,0,0,0.00213219616204691,469
20,10,10,1,103,1,0,0,631
3716,2182,1534,39,4,2,0,0.000579038795599305,3454
17,0,17,1,76,0,0,0,79
220,44,176,7,7,1,0,0.000482160077145612,2074
143,0,143,3,17,0,0,0,92
70,0,70,1,49,0,0,0,128
22,17,5,3,64,2,0,0,410
778,168,610,11,51,4,0,0,641
0,0,0,1,49,0,0,0,402
8,3,5,3,5,0,0,0,95
0,0,0,1,4,0,0,0,0
0,0,0,1,4,0,0,0,0
13,7,6,2,7,1,0,0,509
117,67,50,2,2,1,0,0,191
56,1,55,2,42,1,0,0,1834
123,0,123,3,68,0,0,0,147
98,31,67,5,9,0,0,0,1860
6,3,3,1,25,0,0,0,436
404,2,402,10,25,0,0,0,7726
513,2,511,6,17,0,0,0,419
4,2,2,1,64,0,0,0,530
1,0,1,1,95,0,0,0,125
27,4,23,3,11,0,0,0,118
277,208,69,8,2,2,0,0.00403225806451613,744
409,209,200,23,2,6,0,0.00103626943005181,965
8,4,4,2,103,0,0,0,77
80,42,38,3,19,1,0,0.00364963503649635,274
183,107,76,11,19,3,0,0.00163265306122449,2450
91,46,45,6,44,3,1,0.00425230333097094,1411
37,3,34,4,68,0,0,0,163
97,53,44,3,64,0,0,0.0012853470437018,778
133,41,92,8,7,2,0,0.000413052457662123,2421
875,400,475,18,6,1,0,0.00321027287319422,1246
1870,932,938,54,8,16,0,0.00301104048176648,5978
87,84,3,1,60,1,0,0.00261780104712042,382
255,58,197,10,20,0,0,0.00061012812690665,1639
1414,1195,219,22,7,2,0,0.00180959083140645,9947
373,199,174,13,25,1,0,0.000377643504531722,2648
77,8,69,7,17,0,0,0,257
269,140,129,17,7,4,0,0.00818926296633303,1099
6,6,0,1,20,0,0,0,82
58,25,33,5,19,1,0,0,965
8,4,4,2,64,0,0,0,494
19,13,6,2,101,2,0,0,566
0,0,0,1,20,0,0,0,0
372,343,29,9,6,1,0,0,0
13,6,7,4,96,3,0,0,1396
109,107,2,4,86,1,0,0.000967117988394584,1034
163,108,55,6,68,1,0,0,229
484,341,143,7,51,2,0,0,2762
122,78,44,6,26,1,0,0.00178126113288208,2807
64,40,24,6,4,0,0,0,959
24,12,12,3,41,0,0,0,47
5,5,0,2,5,0,0,0,0
2,1,1,1,95,0,0,0,65
4,4,0,2,55,1,0,0,87
2,1,1,1,88,1,0,0,45
119,85,34,7,0,3,0,0.0154320987654321,324
4,4,0,1,26,0,0,0,48
2,1,1,1,97,1,0,0,90
0,0,0,1,109,0,0,0.0121951219512195,82
0,0,0,1,88,0,0,0,0
32,25,7,4,97,1,0,0,0
34,17,17,3,18,0,0,0.00134048257372654,746
24,12,12,2,17,0,0,0,74
28,16,12,2,17,0,0,0,124
38,20,18,2,17,0,0,0,80
20,10,10,2,17,0,0,0,63
24,12,12,2,17,0,0,0,71
369,135,234,10,4,1,0,0,847
496,192,304,17,18,2,0,0.00107411385606874,931
27,14,13,3,18,0,0,0,1208
66,42,24,6,3,2,0,0.00256410256410256,780
9,2,7,2,18,1,0,0.00303951367781155,329
144,19,125,3,106,1,0,0,332
42,21,21,3,18,0,0,0,223
182,91,91,2,4,0,1,0.00227963525835866,1316
77,46,31,4,18,2,0,0,340
209,98,111,2,0,1,0,0,212
196,170,26,6,3,2,0,0.0029806259314456,671
3,1,2,1,18,0,0,0,169
21,6,15,5,18,1,0,0,152
12,4,8,2,33,0,0,0.0135746606334842,221
16,8,8,3,18,1,0,0.00104493207941484,957
114,56,58,7,4,2,1,0.00524658971668416,953
152,55,97,8,18,1,0,0,537
30,4,26,6,3,0,0,0,0
27,8,19,6,3,0,0,0,0
533,296,237,16,6,4,0,0.001230012300123,813
12,6,6,3,10,0,0,0.000430848772081,4642
9,4,5,3,18,1,0,0,152
22,11,11,3,18,0,0,0,695
26,8,18,3,18,0,0,0,761
9,4,5,3,18,0,0,0,215
43,20,23,4,18,0,0,0,309
38,24,14,4,4,1,1,0.00232018561484919,1724
29,14,15,5,11,0,0,0,691
6,3,3,1,104,0,0,0,37
90,33,57,4,18,1,0,0.00189753320683112,527
10,7,3,2,88,1,0,0,438
26,13,13,1,104,0,0,0,247
556,303,253,38,0,10,0,0.00104529616724739,2870
1332,805,527,39,17,13,3,0.00357675111773472,3355
168,72,96,7,3,2,0,0.00214592274678112,932
152,86,66,4,3,0,0,0,301
136,56,80,4,3,0,0,0,249
73,27,46,9,6,2,0,0,832
244,131,113,11,6,0,0,0,320
458,229,229,17,4,5,1,0.000926354793886058,4318
1599,801,798,38,1,7,0,0.00153609831029186,1953
142,73,69,2,18,0,0,0,1539
1557,834,723,48,0,10,1,0.00179359823399559,7248
39,26,13,4,18,2,0,0,741
24,5,19,1,18,0,0,0,476
624,190,434,24,0,5,0,0.0019907100199071,1507
46,8,38,4,18,0,0,0.00147383935151069,1357
20,11,9,2,18,1,0,0,332
262,133,129,17,11,1,0,0.000549450549450549,1820
10,6,4,2,53,2,0,0,282
2,1,1,1,18,0,0,0,77
2,1,1,1,104,0,0,0,149
849,451,398,34,0,8,0,0.000885515496521189,7905
114,57,57,6,18,2,0,0.00650759219088937,461
8,4,4,1,18,0,0,0,630
21,9,12,3,4,0,0,0.00103305785123967,968
0,0,0,1,4,0,0,0,851
0,0,0,1,4,0,0,0,121
0,0,0,1,4,0,0,0,96
0,0,0,1,4,0,0,0,27
0,0,0,1,4,0,0,0,66
0,0,0,1,4,0,0,0,8
0,0,0,1,4,0,0,0,31
0,0,0,1,4,0,0,0,4
48,41,7,3,3,0,0,0.00186741363211951,1071
17,9,8,3,0,0,0,0.00141442715700141,707
11,6,5,2,0,0,0,0.00176991150442478,565
27,19,8,1,5,0,0,0,145
19,15,4,1,24,1,0,0.00306748466257669,326
4,2,2,1,86,0,0,0,487
22,13,9,1,96,0,0,0,61
283,243,40,13,0,4,0,0.00315900315900316,5698
6,5,1,1,24,1,0,0.00515463917525773,194
2,1,1,1,101,0,0,0.0016366612111293,611
59,57,2,3,4,1,0,0,231
10,9,1,2,3,0,0,0.00128700128700129,777
10,10,0,1,76,0,0,0.00617283950617284,162
65,47,18,9,11,2,0,0.00115074798619102,2607
4,2,2,1,86,0,0,0.00143884892086331,695
5,2,3,1,26,1,0,0.00268817204301075,372
76,47,29,2,86,0,0,0.00339270568278202,1179
28,13,15,3,86,1,0,0,208
104,104,0,2,0,0,0,0,0
182,130,52,1,4,0,0,0,441
8,6,2,1,26,1,0,0,451
4,2,2,1,21,0,0,0,0
8,8,0,3,3,0,0,0.00201612903225806,496
11,6,5,2,70,2,0,0,1368
34,19,15,2,55,0,0,0,535
2,1,1,1,107,0,0,0,143
134,58,76,17,0,6,0,0.00138638569249965,7213
17,7,10,3,51,1,0,0.00986193293885602,507
80,40,40,3,73,0,0,0.00238379022646007,2517
4,2,2,2,10,1,0,0,1311
5,4,1,1,17,0,0,0,708
278,260,18,6,66,0,0,0.00196078431372549,510
178,119,59,6,17,1,0,0.00135869565217391,736
19,10,9,3,4,0,0,0.000515995872033024,1938
44,20,24,1,42,0,0,0,265
4,3,1,1,26,1,0,0,240
4,2,2,1,106,0,0,0.000931966449207828,1073
45,41,4,3,26,1,0,0.00154798761609907,646
4,2,2,2,95,0,0,0,369
37,25,12,4,57,1,0,0.00199760287654814,2503
31,17,14,3,81,0,0,0.000908265213442325,1101
2,1,1,1,26,1,0,0.0033003300330033,303
127,73,54,4,29,0,0,0.00161550888529887,619
233,188,45,6,0,1,0,0.000858369098712446,1165
46,24,22,4,5,0,0,0,1400
40,22,18,3,43,0,0,0.00161550888529887,619
9,5,4,3,22,1,0,0,287
28,22,6,1,26,1,0,0.00454545454545455,660
23,16,7,3,17,0,0,0.00163398692810458,612
38,20,18,2,43,1,0,0,332
2,1,1,1,11,1,0,0.00206185567010309,485
12,6,6,1,104,0,0,0,541
26,23,3,3,18,0,0,0.00230414746543779,434
15,9,6,4,27,1,0,0.00148367952522255,674
5,2,3,2,27,1,0,0,119
10,6,4,3,11,3,0,0,455
21,12,9,5,20,2,0,0,1490
138,53,85,13,4,3,0,0.00122249388753056,818
764,439,325,9,56,3,1,0.000846023688663283,1182
8,8,0,1,112,1,0,0,286
41,8,33,3,4,0,0,0.00217391304347826,460
18,18,0,1,112,0,0,0,443
6,3,3,1,56,0,0,0.00254452926208651,393
218,0,218,3,4,0,0,0.00202702702702703,1480
932,326,606,13,0,0,1,0.000833333333333333,1200
188,60,128,8,0,0,0,0.00114810562571757,871
12,8,4,1,59,0,0,0.0109489051094891,274
171,108,63,7,56,2,0,0,387
4,2,2,1,56,0,0,0,109
401,253,148,18,4,5,0,0.00313971742543171,1274
50,33,17,3,19,0,0,0,416
240,178,62,5,26,3,0,0,1472
24,12,12,1,61,1,0,0,1125
34,24,10,4,10,1,0,0.000468274408803559,4271
115,51,64,14,0,4,0,0.00167294019238812,2391
411,318,93,6,20,1,0,0,1027
396,255,141,20,4,3,0,0.00204918032786885,1464
45,0,45,2,4,0,0,0,0
51,32,19,5,7,2,0,0.00107123727905731,1867
63,63,0,1,91,0,0,0.00176678445229682,566
4,2,2,2,11,1,0,0,802
32,25,7,3,74,1,0,0.000801282051282051,2496
41,19,22,4,7,3,0,0,752
112,46,66,14,4,1,0,0.00168350168350168,594
0,0,0,1,4,0,0,0,0
200,162,38,4,23,0,0,0,0
67,35,32,3,66,1,0,0.000829875518672199,1205
0,0,0,1,4,0,0,0,0
45,44,1,2,91,0,0,0,655
10,8,2,2,7,1,0,0.00468933177022274,853
28,22,6,3,7,3,0,0.000582750582750583,1716
10,8,2,1,7,1,0,0.00404858299595142,247
11,6,5,2,28,0,0,0,0
0,0,0,1,36,0,0,0,0
140,140,0,2,5,0,0,0,0
0,0,0,1,36,0,0,0,0
1,1,0,1,98,0,0,0,0
33,21,12,3,1,0,0,0,0
0,0,0,1,36,0,0,0,0
11,6,5,4,28,1,0,0,0
20,10,10,1,28,0,0,0,0
2,1,1,1,28,0,0,0,0
0,0,0,1,36,0,0,0,0
29,15,14,6,18,1,0,0,0
0,0,0,1,36,0,0,0,0
24,12,12,2,98,0,0,0,0
126,90,36,6,28,2,0,0,0
36,26,10,7,28,2,0,0,0
44,22,22,2,85,0,0,0,0
18,9,9,2,5,0,0,0,0
10,5,5,1,85,0,0,0,0
11,6,5,4,28,1,0,0,0
8,4,4,1,28,0,0,0,0
26,23,3,3,85,1,0,0,0
2,1,1,1,107,1,0,0,0
4,3,1,2,98,1,0,0,0
1,1,0,1,98,0,0,0,0
1,1,0,1,98,0,0,0,0
1,0,1,1,94,0,0,0,0
57,26,31,5,23,0,0,0,0
4,2,2,1,28,0,0,0,0
10,5,5,2,28,1,0,0,0
12,7,5,4,53,1,0,0,0
7,6,1,6,85,0,0,0,0
2,1,1,1,28,0,0,0,0
3,2,1,2,94,0,0,0,0
2,1,1,1,5,0,0,0,0
26,13,13,2,86,0,0,0,0
5,3,2,1,86,0,0,0,0
1,1,0,1,98,0,0,0,0
13,0,13,1,98,0,0,0,0
1,0,1,1,86,0,0,0,0
34,15,19,3,85,0,0,0,0
19,8,11,4,86,0,0,0,0
31,13,18,3,85,0,0,0,0
3,0,3,2,94,0,0,0,0
5,1,4,2,35,0,0,0,0
0,0,0,1,36,0,0,0,0
25,15,10,6,28,1,0,0,0
146,3,143,2,5,0,0,0,0
16,6,10,3,5,1,0,0,0
1,1,0,1,85,1,0,0,0
2,1,1,1,36,1,0,0,0
18,15,3,2,18,1,0,0,0
2,1,1,1,36,0,0,0,0
2,1,1,1,35,1,0,0,0
2,1,1,1,34,0,0,0,0
1,1,0,1,34,0,0,0,0
0,0,0,1,4,0,0,0,0
0,0,0,1,4,0,0,0,0
0,0,0,1,4,0,0,0,0
0,0,0,1,4,0,0,0,0
0,0,0,1,4,0,0,0,0
0,0,0,1,4,0,0,0,0
0,0,0,1,4,0,0,0,0
0,0,0,1,4,0,0,0,0
17,9,8,1,116,0,0,0,0
90,45,45,4,103,1,0,0,0
55,37,18,5,28,1,0,0,0
15,10,5,5,28,1,0,0,0
67,45,22,5,28,1,0,0,0
92,62,30,13,19,3,0,0,0
24,18,6,3,95,0,0,0,0
3,2,1,2,41,1,0,0,0
0,0,0,1,28,0,0,0,0
6,3,3,2,28,0,0,0,0
4,2,2,2,28,1,0,0,0
0,0,0,1,28,0,0,0,0
2,1,1,2,28,1,0,0,0
3,1,2,3,28,2,0,0,0
3,1,2,3,28,2,0,0,0
1,0,1,2,28,1,0,0,0
0,0,0,1,28,0,0,0,0
8,4,4,6,28,3,0,0,0
0,0,0,1,28,0,0,0,0
0,0,0,1,28,0,0,0,0
0,0,0,1,28,0,0,0,0
0,0,0,1,28,0,0,0,0
0,0,0,1,28,0,0,0,0
0,0,0,1,28,0,0,0,0
0,0,0,1,28,0,0,0,0
0,0,0,1,28,0,0,0,0
0,0,0,1,28,0,0,0,0
0,0,0,1,28,0,0,0,0
0,0,0,1,28,0,0,0,0
0,0,0,1,28,0,0,0,0
0,0,0,1,28,0,0,0,0
0,0,0,1,28,0,0,0,0
0,0,0,1,28,0,0,0,0
0,0,0,1,28,0,0,0,0
0,0,0,1,28,0,0,0,0
0,0,0,1,28,0,0,0,0
0,0,0,1,28,0,0,0,0
0,0,0,1,28,0,0,0,0
0,0,0,1,28,0,0,0,0
0,0,0,1,28,0,0,0,0
0,0,0,1,28,0,0,0,0
0,0,0,1,28,0,0,0,0
0,0,0,1,28,0,0,0,0
0,0,0,1,28,0,0,0,0
0,0,0,1,28,0,0,0,0
0,0,0,1,28,0,0,0,0
0,0,0,1,28,0,0,0,0
0,0,0,1,28,0,0,0,0
0,0,0,1,28,0,0,0,0
0,0,0,1,28,0,0,0,0
0,0,0,1,28,0,0,0,0
0,0,0,1,28,0,0,0,0
0,0,0,1,28,0,0,0,0
0,0,0,1,28,0,0,0,0
0,0,0,1,28,0,0,0,0
0,0,0,1,28,0,0,0,0
0,0,0,1,28,0,0,0,0
0,0,0,1,28,0,0,0,0
0,0,0,1,28,0,0,0,0
0,0,0,1,28,0,0,0,0
0,0,0,1,28,0,0,0,0
0,0,0,1,28,0,0,0,0
0,0,0,1,28,0,0,0,0
0,0,0,1,28,0,0,0,0
0,0,0,1,28,0,0,0,0
0,0,0,1,28,0,0,0,0
4,2,2,2,41,1,0,0,0
2,2,0,1,98,0,0,0,0
4,2,2,2,28,1,0,0,0
131,89,42,8,5,2,0,0,0
98,50,48,2,101,1,0,0,0
2,1,1,1,107,1,0,0,0
2,1,1,1,107,1,0,0,0
6,3,3,2,28,1,0,0,0
2,1,1,1,107,1,0,0,0
2,1,1,1,28,0,0,0,0
169,159,10,3,38,1,0,0,0
64,51,13,3,28,1,0,0,0
6,3,3,2,41,0,0,0,0
450,376,74,5,41,1,0,0,0
0,0,0,1,41,0,0,0,0
0,0,0,1,41,0,0,0,0
0,0,0,1,41,0,0,0,0
1,0,1,1,94,0,0,0,0
66,56,10,5,34,2,0,0,0
628,405,223,7,67,2,0,0,0
9,5,4,2,41,0,0,0,0
2,1,1,1,107,1,0,0,0
4,2,2,3,41,0,0,0,0
18,12,6,3,70,1,0,0,0
2,1,1,1,103,0,0,0,0
351,262,89,10,34,4,0,0,0
211,139,72,5,52,1,0,0,0
2,1,1,1,107,1,0,0,0
6,3,3,2,41,1,0,0,0
2,1,1,1,41,0,0,0,0
7,3,4,3,41,1,0,0,0
76,19,57,6,28,1,0,0,0
62,59,3,3,41,1,0,0,0
2,1,1,1,41,0,0,0,0
119,64,55,2,53,0,0,0,0
393,198,195,6,36,4,0,0,0
5,2,3,2,94,0,0,0,0
10,5,5,2,28,1,0,0,0
29,28,1,3,28,0,0,0,0
4,2,2,2,28,1,0,0,0
10,6,4,2,38,0,0,0,0
183,140,43,7,34,2,0,0,0
53,43,10,4,74,1,0,0,0
38,19,19,1,34,1,0,0,0
5,2,3,2,100,1,0,0,0
224,171,53,7,37,2,0,0,0
3,0,3,1,118,1,0,0,0
94,47,47,1,91,0,0,0,0
150,75,75,1,91,0,0,0,0
220,110,110,1,91,0,0,0,0
54,27,27,1,91,0,0,0,0
86,43,43,1,91,0,0,0,0
58,29,29,1,91,0,0,0,0
54,27,27,1,91,0,0,0,0
132,66,66,1,91,0,0,0,0
340,170,170,1,91,0,0,0,0
120,58,62,3,90,0,0,0,0
92,46,46,1,91,0,0,0,0
58,29,29,1,91,0,0,0,0
56,28,28,1,91,0,0,0,0
218,109,109,1,91,0,0,0,0
72,36,36,1,91,0,0,0,0
50,25,25,1,91,0,0,0,0
60,30,30,1,91,0,0,0,0
58,29,29,1,91,0,0,0,0
60,30,30,2,91,0,0,0,0
52,26,26,2,91,0,0,0,0
252,141,111,1,91,0,0,0,0
70,44,26,1,91,0,0,0,0
64,32,32,1,91,0,0,0,0
50,25,25,1,91,0,0,0,0
50,25,25,1,91,0,0,0,0
56,28,28,1,91,0,0,0,0
58,29,29,1,91,0,0,0,0
56,28,28,1,91,0,0,0,0
50,25,25,1,91,0,0,0,0
84,42,42,1,91,0,0,0,0
52,26,26,1,91,0,0,0,0
50,25,25,1,91,0,0,0,0
88,44,44,1,91,0,0,0,0
58,29,29,1,91,0,0,0,0
78,39,39,1,91,0,0,0,0
64,32,32,1,91,0,0,0,0
110,55,55,1,91,0,0,0,0
68,34,34,1,91,0,0,0,0
58,29,29,1,91,0,0,0,0
52,26,26,1,91,0,0,0,0
68,34,34,1,91,0,0,0,0
50,25,25,1,91,0,0,0,0
58,29,29,1,91,0,0,0,0
50,25,25,1,91,0,0,0,0
52,26,26,1,91,0,0,0,0
50,25,25,1,91,0,0,0,0
68,34,34,1,91,0,0,0,0
50,25,25,1,91,0,0,0,0
50,25,25,1,91,0,0,0,0
34,17,17,1,91,0,0,0,0
2,1,1,1,91,0,0,0,0
82,41,41,1,91,0,0,0,0
62,31,31,1,91,0,0,0,0
68,34,34,1,91,0,0,0,0
50,25,25,1,91,0,0,0,0
50,25,25,1,91,0,0,0,0
87,46,41,1,91,0,0,0,0
50,25,25,1,91,0,0,0,0
71,42,29,1,91,0,0,0,0
52,26,26,1,91,0,0,0,0
50,25,25,1,91,0,0,0,0
52,26,26,1,91,0,0,0,0
56,25,31,1,91,0,0,0,0
77,49,28,1,91,0,0,0,0
50,25,25,1,91,0,0,0,0
78,39,39,1,91,0,0,0,0
142,71,71,1,91,0,0,0,0
75,37,38,1,91,0,0,0,0
62,31,31,1,91,0,0,0,0
68,34,34,1,91,0,0,0,0
106,53,53,1,91,0,0,0,0
50,25,25,1,91,0,0,0,0
22,11,11,1,91,0,0,0,0
50,25,25,1,91,0,0,0,0
60,30,30,1,91,0,0,0,0
54,27,27,1,91,0,0,0,0
54,27,27,1,91,0,0,0,0
54,27,27,1,91,0,0,0,0
50,25,25,1,91,0,0,0,0
50,25,25,1,91,0,0,0,0
58,29,29,1,91,0,0,0,0
50,25,25,1,91,0,0,0,0
56,28,28,1,91,0,0,0,0
50,25,25,1,91,0,0,0,0
50,25,25,1,91,0,0,0,0
59,33,26,1,91,0,0,0,0
60,30,30,1,91,0,0,0,0
52,26,26,1,91,0,0,0,0
56,28,28,1,91,0,0,0,0
56,28,28,1,91,0,0,0,0
50,25,25,1,91,0,0,0,0
50,25,25,1,91,0,0,0,0
198,104,94,1,91,0,0,0,0
52,26,26,1,91,0,0,0,0
60,30,30,1,91,0,0,0,0
54,27,27,1,91,0,0,0,0
50,25,25,1,91,0,0,0,0
54,27,27,1,91,0,0,0,0
20,10,10,1,91,0,0,0,0
50,25,25,1,91,0,0,0,0
52,26,26,1,91,0,0,0,0
50,25,25,1,91,0,0,0,0
54,27,27,1,91,0,0,0,0
50,25,25,1,91,0,0,0,0
86,43,43,1,91,0,0,0,0
14,13,1,1,91,0,0,0,0
58,29,29,1,91,0,0,0,0
58,29,29,1,91,0,0,0,0
70,35,35,1,91,0,0,0,0
8,4,4,1,91,0,0,0,0
11,7,4,1,91,0,0,0,0
50,25,25,1,91,0,0,0,0
52,26,26,1,91,0,0,0,0
50,25,25,1,91,0,0,0,0
4,2,2,1,91,0,0,0,0
50,25,25,1,91,0,0,0,0
50,25,25,1,91,0,0,0,0
2,1,1,1,91,0,0,0,0
2,1,1,1,91,0,0,0,0
68,45,23,1,91,0,0,0,0
2,2,0,1,91,0,0,0,0
2,1,1,1,91,0,0,0,0
50,25,25,1,91,0,0,0,0
52,26,26,1,91,0,0,0,0
52,26,26,1,91,0,0,0,0
50,25,25,1,91,0,0,0,0
50,25,25,1,91,0,0,0,0
4,2,2,1,91,0,0,0,0
2,1,1,1,91,0,0,0,0
86,43,43,1,91,0,0,0,0
6,3,3,1,91,0,0,0,0
6,3,3,1,91,0,0,0,0
2,1,1,1,91,0,0,0,0
60,30,30,1,91,0,0,0,0
12,6,6,1,91,0,0,0,0
12,6,6,1,91,0,0,0,0
58,29,29,1,91,0,0,0,0
50,25,25,1,91,0,0,0,0
22,11,11,1,91,0,0,0,0
12,6,6,1,91,0,0,0,0
18,9,9,1,91,0,0,0,0
12,6,6,1,91,0,0,0,0
258,129,129,1,91,0,0,0,0
26,13,13,1,91,0,0,0,0
16,8,8,1,91,0,0,0,0
52,26,26,1,91,0,0,0,0
68,34,34,1,91,0,0,0,0
50,25,25,1,91,0,0,0,0
50,25,25,1,91,0,0,0,0
50,25,25,1,91,0,0,0,0
58,29,29,1,91,0,0,0,0
50,25,25,1,91,0,0,0,0
56,28,28,1,91,0,0,0,0
52,26,26,1,91,0,0,0,0
105,71,34,1,91,0,0,0,0
29,19,10,1,91,0,0,0,0
22,11,11,1,91,0,0,0,0
52,26,26,1,91,0,0,0,0
12,6,6,1,91,0,0,0,0
272,136,136,1,91,0,0,0,0
12,6,6,1,91,0,0,0,0
12,6,6,1,91,0,0,0,0
12,6,6,1,91,0,0,0,0
12,6,6,1,91,0,0,0,0
12,6,6,1,91,0,0,0,0
12,6,6,1,91,0,0,0,0
12,6,6,1,91,0,0,0,0
60,30,30,1,91,0,0,0,0
50,25,25,1,91,0,0,0,0
54,27,27,1,91,0,0,0,0
60,30,30,1,91,0,0,0,0
4,2,2,1,91,0,0,0,0
58,29,29,1,91,0,0,0,0
52,26,26,1,91,0,0,0,0
64,32,32,1,91,0,0,0,0
50,25,25,1,91,0,0,0,0
50,25,25,1,91,0,0,0,0
74,37,37,1,91,0,0,0,0
14,7,7,1,91,0,0,0,0
12,6,6,1,91,0,0,0,0
12,6,6,1,91,0,0,0,0
2,1,1,1,91,0,0,0,0
12,6,6,1,91,0,0,0,0
72,36,36,1,91,0,0,0,0
68,34,34,1,91,0,0,0,0
50,25,25,1,91,0,0,0,0
12,6,6,1,91,0,0,0,0
12,6,6,1,91,0,0,0,0
16,8,8,1,91,0,0,0,0
62,31,31,1,91,0,0,0,0
12,6,6,1,91,0,0,0,0
78,39,39,1,91,0,0,0,0
56,28,28,1,91,0,0,0,0
92,46,46,1,91,0,0,0,0
90,45,45,1,91,0,0,0,0
58,29,29,1,91,0,0,0,0
50,25,25,1,91,0,0,0,0
116,58,58,2,91,0,0,0,0
66,33,33,1,91,0,0,0,0
112,56,56,1,91,0,0,0,0
62,31,31,1,91,0,0,0,0
128,64,64,1,91,0,0,0,0
242,121,121,1,91,0,0,0,0
16,8,8,1,91,0,0,0,0
64,32,32,1,91,0,0,0,0
200,100,100,1,91,0,0,0,0
68,34,34,1,91,0,0,0,0
68,34,34,1,91,0,0,0,0
64,32,32,1,91,0,0,0,0
50,25,25,1,91,0,0,0,0
56,28,28,1,91,0,0,0,0
94,47,47,1,91,0,0,0,0
56,28,28,1,91,0,0,0,0
84,42,42,1,91,0,0,0,0
76,38,38,1,91,0,0,0,0
62,31,31,1,91,0,0,0,0
52,26,26,1,91,0,0,0,0
128,63,65,1,91,0,0,0,0
92,46,46,1,91,0,0,0,0
60,30,30,1,91,0,0,0,0
104,52,52,1,91,0,0,0,0
50,25,25,1,91,0,0,0,0
156,78,78,1,91,0,0,0,0
58,29,29,1,91,0,0,0,0
130,65,65,1,91,0,0,0,0
6,3,3,1,91,0,0,0,0
54,27,27,1,91,0,0,0,0
60,30,30,1,91,0,0,0,0
52,26,26,1,91,0,0,0,0
304,278,26,1,91,0,0,0,0
170,98,72,1,91,0,0,0,0
60,30,30,1,91,0,0,0,0
164,86,78,1,91,0,0,0,0
120,60,60,1,91,0,0,0,0
50,25,25,1,91,0,0,0,0
66,33,33,1,91,0,0,0,0
54,27,27,1,91,0,0,0,0
68,34,34,1,91,0,0,0,0
452,351,101,1,91,0,0,0,0
114,57,57,1,91,0,0,0,0
73,48,25,1,91,0,0,0,0
112,74,38,1,91,0,0,0,0
50,25,25,1,91,0,0,0,0
52,26,26,1,91,0,0,0,0
324,237,87,1,91,0,0,0,0
76,39,37,1,91,0,0,0,0
56,29,27,1,91,0,0,0,0
52,26,26,1,91,0,0,0,0
95,57,38,1,91,0,0,0,0
792,451,341,1,91,0,0,0,0
84,42,42,1,91,0,0,0,0
50,25,25,1,91,0,0,0,0
94,60,34,1,91,0,0,0,0
55,28,27,1,91,0,0,0,0
216,126,90,1,91,0,0,0,0
50,25,25,1,91,0,0,0,0
50,25,25,1,91,0,0,0,0
50,25,25,1,91,0,0,0,0
52,26,26,1,91,0,0,0,0
0,0,0,1,85,0,0,0,0
101,71,30,1,91,0,0,0,0
57,29,28,1,91,0,0,0,0
55,28,27,1,91,0,0,0,0
85,44,41,1,91,0,0,0,0
71,36,35,1,91,0,0,0,0
229,119,110,1,91,0,0,0,0
50,25,25,1,91,0,0,0,0
52,26,26,1,91,0,0,0,0
52,26,26,1,91,0,0,0,0
37,21,16,1,91,0,0,0,0
192,97,95,1,91,0,0,0,0
45,28,17,1,91,0,0,0,0
53,26,27,1,91,0,0,0,0
103,53,50,1,91,0,0,0,0
82,44,38,1,91,0,0,0,0
245,161,84,1,91,0,0,0,0
153,91,62,1,91,0,0,0,0
93,48,45,1,91,0,0,0,0
52,26,26,1,91,0,0,0,0
86,45,41,1,91,0,0,0,0
62,31,31,1,91,0,0,0,0
61,36,25,1,91,0,0,0,0
137,71,66,1,91,0,0,0,0
54,27,27,1,91,0,0,0,0
89,49,40,1,91,0,0,0,0
91,56,35,1,91,0,0,0,0
58,29,29,1,91,0,0,0,0
108,56,52,1,91,0,0,0,0
50,25,25,1,91,0,0,0,0
63,32,31,1,91,0,0,0,0
60,29,31,1,91,0,0,0,0
52,26,26,1,91,0,0,0,0
68,34,34,1,91,0,0,0,0
32,16,16,1,91,0,0,0,0
196,116,80,1,91,0,0,0,0
57,29,28,1,91,0,0,0,0
399,228,171,1,91,0,0,0,0
67,36,31,1,91,0,0,0,0
248,148,100,1,91,0,0,0,0
56,28,28,2,91,0,0,0,0
50,25,25,1,91,0,0,0,0
105,55,50,1,91,0,0,0,0
68,36,32,1,91,0,0,0,0
76,38,38,1,91,0,0,0,0
70,35,35,1,91,0,0,0,0
159,81,78,1,91,0,0,0,0
80,42,38,1,91,0,0,0,0
98,57,41,1,91,0,0,0,0
54,27,27,1,91,0,0,0,0
60,31,29,1,91,0,0,0,0
50,25,25,1,91,0,0,0,0
54,27,27,1,91,0,0,0,0
50,25,25,1,91,0,0,0,0
2,1,1,1,91,0,0,0,0
50,25,25,1,91,0,0,0,0
121,75,46,1,91,0,0,0,0
56,28,28,1,91,0,0,0,0
129,71,58,1,91,0,0,0,0
177,95,82,1,91,0,0,0,0
50,25,25,1,91,0,0,0,0
64,32,32,1,91,0,0,0,0
50,25,25,1,91,0,0,0,0
133,71,62,1,91,0,0,0,0
6,3,3,1,91,0,0,0,0
12,6,6,1,91,0,0,0,0
12,6,6,1,91,0,0,0,0
12,6,6,1,91,0,0,0,0
50,25,25,1,91,0,0,0,0
12,6,6,1,91,0,0,0,0
12,6,6,1,91,0,0,0,0
12,6,6,1,91,0,0,0,0
12,6,6,1,91,0,0,0,0
12,6,6,1,91,0,0,0,0
12,6,6,1,91,0,0,0,0
12,6,6,1,91,0,0,0,0
12,6,6,1,91,0,0,0,0
12,6,6,1,91,0,0,0,0
14,7,7,1,91,0,0,0,0
12,6,6,1,91,0,0,0,0
133,80,53,1,91,0,0,0,0
68,38,30,1,91,0,0,0,0
12,6,6,1,91,0,0,0,0
12,6,6,1,91,0,0,0,0
12,6,6,1,91,0,0,0,0
14,7,7,1,91,0,0,0,0
12,6,6,1,91,0,0,0,0
8,4,4,1,91,0,0,0,0
12,6,6,1,91,0,0,0,0
12,6,6,1,91,0,0,0,0
12,6,6,1,91,0,0,0,0
12,6,6,1,91,0,0,0,0
12,6,6,1,91,0,0,0,0
50,25,25,1,91,0,0,0,0
12,6,6,1,91,0,0,0,0
12,6,6,1,91,0,0,0,0
50,25,25,1,91,0,0,0,0
50,25,25,1,91,0,0,0,0
50,25,25,1,91,0,0,0,0
50,25,25,1,91,0,0,0,0
50,25,25,1,91,0,0,0,0
44,22,22,1,91,0,0,0,0
12,6,6,1,91,0,0,0,0
10,5,5,2,91,0,0,0,0
20,10,10,1,91,0,0,0,0
64,32,32,1,91,0,0,0,0
16,8,8,1,91,0,0,0,0
12,6,6,1,91,0,0,0,0
14,7,7,1,91,0,0,0,0
12,6,6,1,91,0,0,0,0
66,35,31,1,91,0,0,0,0
14,7,7,1,91,0,0,0,0
50,25,25,1,91,0,0,0,0
12,6,6,1,91,0,0,0,0
50,25,25,1,91,0,0,0,0
50,25,25,1,91,0,0,0,0
50,25,25,1,91,0,0,0,0
12,6,6,1,91,0,0,0,0
12,6,6,1,91,0,0,0,0
56,28,28,1,91,0,0,0,0
2,1,1,1,91,0,0,0,0
50,25,25,1,91,0,0,0,0
50,25,25,1,91,0,0,0,0
50,25,25,1,91,0,0,0,0
2,1,1,1,91,0,0,0,0
2,1,1,1,91,0,0,0,0
2,1,1,1,91,0,0,0,0
2,1,1,1,91,0,0,0,0
2,1,1,1,91,0,0,0,0
2,1,1,1,91,0,0,0,0
54,27,27,1,91,0,0,0,0
50,25,25,1,91,0,0,0,0
50,25,25,1,91,0,0,0,0
2,1,1,1,91,0,0,0,0
2,1,1,1,91,0,0,0,0
50,25,25,1,91,0,0,0,0
2,1,1,1,91,0,0,0,0
74,37,37,1,91,0,0,0,0
2,1,1,1,91,0,0,0,0
50,25,25,1,91,0,0,0,0
50,25,25,1,91,0,0,0,0
3,2,1,1,98,0,0,0,0
33,0,33,1,85,0,0,0,0
17,6,11,5,86,1,0,0,0
13,2,11,2,94,0,0,0,0
2,0,2,2,96,0,0,0,0
26,17,9,7,28,2,0,0,0
20,11,9,4,28,1,0,0,0
3,2,1,2,28,0,0,0,0
51,34,17,6,28,1,0,0,0
4,2,2,2,53,0,0,0,0
44,29,15,4,41,1,0,0,0
2,1,1,1,85,0,0,0,0
2,1,1,1,107,1,0,0,0
14,7,7,2,28,1,0,0,0
4,2,2,1,28,0,0,0,0
0,0,0,1,94,0,0,0,0
4,4,0,2,94,0,0,0,0
2,1,1,2,94,1,0,0,0
0,0,0,1,94,0,0,0,0
0,0,0,1,94,0,0,0,0
9,8,1,3,94,0,0,0,0
1,1,0,1,98,0,0,0,0
12,2,10,2,85,0,0,0,0
2,2,0,1,98,0,0,0,0
2,1,1,1,85,0,0,0,0
6,3,3,1,28,0,0,0,0
2,1,1,1,106,1,0,0,0
2,1,1,1,106,1,0,0,0
4,2,2,2,28,1,0,0,0
10,7,3,3,18,1,0,0,0
2,1,1,1,107,1,0,0,0
0,0,0,1,28,0,0,0,0
0,0,0,1,28,0,0,0,0
0,0,0,1,28,0,0,0,0
0,0,0,1,28,0,0,0,0
0,0,0,1,41,0,0,0,0
0,0,0,1,41,0,0,0,0
14,10,4,6,24,0,0,0,0
0,0,0,1,41,0,0,0,0
0,0,0,1,41,0,0,0,0
0,0,0,1,41,0,0,0,0
0,0,0,2,34,0,0,0,0
0,0,0,1,41,0,0,0,0
6,5,1,5,24,1,0,0,0
0,0,0,1,41,0,0,0,0
0,0,0,1,41,0,0,0,0
0,0,0,1,41,0,0,0,0
0,0,0,1,41,0,0,0,0
0,0,0,1,41,0,0,0,0
0,0,0,1,41,0,0,0,0
1,1,0,2,41,0,0,0,0
0,0,0,1,41,0,0,0,0
0,0,0,1,41,0,0,0,0
0,0,0,1,41,0,0,0,0
0,0,0,1,41,0,0,0,0
54,35,19,7,18,2,0,0,0
0,0,0,1,106,0,0,0,0
0,0,0,1,106,0,0,0,0
0,0,0,1,106,0,0,0,0
0,0,0,1,106,0,0,0,0
0,0,0,1,106,0,0,0,0
0,0,0,1,106,0,0,0,0
0,0,0,1,106,0,0,0,0
0,0,0,1,106,0,0,0,0
0,0,0,1,106,0,0,0,0
0,0,0,1,106,0,0,0,0
0,0,0,1,106,0,0,0,0
0,0,0,1,106,0,0,0,0
0,0,0,1,106,0,0,0,0
0,0,0,1,106,0,0,0,0
0,0,0,1,106,0,0,0,0
0,0,0,1,106,0,0,0,0
0,0,0,1,106,0,0,0,0
0,0,0,1,106,0,0,0,0
0,0,0,1,106,0,0,0,0
0,0,0,1,106,0,0,0,0
0,0,0,1,106,0,0,0,0
0,0,0,1,106,0,0,0,0
0,0,0,1,106,0,0,0,0
191,139,52,2,41,1,0,0,0
2,0,2,1,38,0,0,0,0
6,3,3,1,91,0,0,0,0
71,43,28,3,5,0,0,0,0
49,48,1,2,38,1,0,0,0
20,20,0,1,41,0,0,0,0
467,402,65,5,38,2,0,0,0
16,10,6,3,41,0,0,0,0
2,1,1,1,91,0,0,0,0
21,14,7,3,41,0,0,0,0
138,113,25,4,28,0,0,0,0
8,4,4,3,5,1,0,0,0
18,13,5,5,28,0,0,0,0
0,0,0,1,38,0,0,0,0
39,20,19,6,5,0,0,0,0
20,10,10,2,28,0,0,0,0
4,2,2,1,91,0,0,0,0
2,1,1,1,41,0,0,0,0
2,2,0,1,98,0,0,0,0
494,413,81,6,38,2,0,0,0
28,2,26,3,41,0,0,0,0
183,144,39,6,5,1,0,0,0
10,9,1,4,28,1,0,0,0
49,18,31,6,38,1,0,0,0
6,3,3,2,41,1,0,0,0
12,4,8,3,33,2,0,0,0
4,2,2,2,41,0,0,0,0
2,1,1,1,41,0,0,0,0
2,1,1,1,41,0,0,0,0
2346,1383,963,21,5,9,0,0,0
90,66,24,7,34,3,0,0,0
88,47,41,4,36,3,0,0,0
238,138,100,8,18,4,0,0,0
14,12,2,2,39,0,0,0,0
14,12,2,2,39,0,0,0,0
28,14,14,4,4,0,0,0,0
2,1,1,1,28,0,0,0,0
4,2,2,1,28,0,0,0,0
7,4,3,2,28,0,0,0,0
23,11,12,3,28,1,0,0,0
54,34,20,10,18,2,0,0,0
4,2,2,1,28,0,0,0,0
2,1,1,1,28,0,0,0,0
2,1,1,1,106,0,0,0,0
2,1,1,1,28,0,0,0,0
2,1,1,1,107,1,0,0,0
27,11,16,6,28,2,0,0,0
2,1,1,1,107,1,0,0,0
49,24,25,3,94,1,0,0,0
1,0,1,1,94,0,0,0,0
3,1,2,1,94,0,0,0,0
370,340,30,8,18,2,0,0,0
7,3,4,4,24,1,0,0,0
31,22,9,4,28,1,0,0,0
0,0,0,1,41,0,0,0,0
58,34,24,3,41,0,0,0,0
30,15,15,8,10,4,0,0,0
4,2,2,1,28,0,0,0,0
2,1,1,1,39,0,0,0,0
2,1,1,1,94,0,0,0,0
12,6,6,2,94,0,0,0,0
8,4,4,2,24,0,0,0,0
4,2,2,1,28,0,0,0,0
4,2,2,2,28,0,0,0,0
2,1,1,1,28,0,0,0,0
15,9,6,2,24,1,0,0,0
8,3,5,3,94,0,0,0,0
190,4,186,1,104,0,0,0,0
3,0,3,1,97,0,0,0,0
4,2,2,2,98,0,0,0,0
80,11,69,5,28,0,0,0,0
20,8,12,4,28,0,0,0,0
11,5,6,4,94,1,0,0,0
21,15,6,5,23,2,0,0,0
23,14,9,5,23,1,0,0,0
4,2,2,2,28,0,0,0,0
12,6,6,2,28,1,0,0,0
12,8,4,2,28,1,0,0,0
16,8,8,2,107,1,0,0,0
2,1,1,1,19,1,0,0,0
39,2,37,3,94,0,0,0,0
2,1,1,1,94,0,0,0,0
43,21,22,5,28,1,0,0,0
4,2,2,1,28,0,0,0,0
4,4,0,1,98,0,0,0,0
2,1,1,3,71,0,0,0,0
134,92,42,6,71,1,0,0,0
61,45,16,5,71,1,0,0,0
0,0,0,1,107,0,0,0,0
0,0,0,1,107,0,0,0,0
0,0,0,1,107,0,0,0,0
0,0,0,1,107,0,0,0,0
0,0,0,1,107,0,0,0,0
0,0,0,1,107,0,0,0,0
0,0,0,1,107,0,0,0,0
0,0,0,1,107,0,0,0,0
15,12,3,2,107,0,0,0,0
9,5,4,2,107,0,0,0,0
0,0,0,1,107,0,0,0,0
0,0,0,1,107,0,0,0,0
0,0,0,1,107,0,0,0,0
0,0,0,1,107,0,0,0,0
0,0,0,1,107,0,0,0,0
16,14,2,3,107,1,0,0,0
0,0,0,1,107,0,0,0,0
0,0,0,1,107,0,0,0,0
0,0,0,1,107,0,0,0,0
0,0,0,1,107,0,0,0,0
0,0,0,1,107,0,0,0,0
0,0,0,1,107,0,0,0,0
0,0,0,1,107,0,0,0,0
0,0,0,1,107,0,0,0,0
0,0,0,1,107,0,0,0,0
0,0,0,1,107,0,0,0,0
0,0,0,1,107,0,0,0,0
0,0,0,1,107,0,0,0,0
0,0,0,1,107,0,0,0,0
0,0,0,1,107,0,0,0,0
0,0,0,1,107,0,0,0,0
9,9,0,2,107,0,0,0,0
0,0,0,1,107,0,0,0,0
0,0,0,1,107,0,0,0,0
0,0,0,1,107,0,0,0,0
0,0,0,1,107,0,0,0,0
0,0,0,1,107,0,0,0,0
0,0,0,1,107,0,0,0,0
0,0,0,1,107,0,0,0,0
0,0,0,1,107,0,0,0,0
0,0,0,1,107,0,0,0,0
0,0,0,1,107,0,0,0,0
0,0,0,1,107,0,0,0,0
0,0,0,1,107,0,0,0,0
0,0,0,1,107,0,0,0,0
2,1,1,1,118,0,0,0,0
20,4,16,3,85,0,0,0,0
0,0,0,1,106,0,0,0,0
0,0,0,1,106,0,0,0,0
0,0,0,1,106,0,0,0,0
0,0,0,1,106,0,0,0,0
0,0,0,1,106,0,0,0,0
0,0,0,1,106,0,0,0,0
0,0,0,1,106,0,0,0,0
0,0,0,1,106,0,0,0,0
0,0,0,1,106,0,0,0,0
0,0,0,1,106,0,0,0,0
0,0,0,1,106,0,0,0,0
0,0,0,1,106,0,0,0,0
0,0,0,1,106,0,0,0,0
0,0,0,1,106,0,0,0,0
0,0,0,1,106,0,0,0,0
0,0,0,1,106,0,0,0,0
0,0,0,1,106,0,0,0,0
0,0,0,1,106,0,0,0,0
0,0,0,1,106,0,0,0,0
0,0,0,1,106,0,0,0,0
0,0,0,1,106,0,0,0,0
0,0,0,1,106,0,0,0,0
0,0,0,1,106,0,0,0,0
0,0,0,1,106,0,0,0,0
0,0,0,1,106,0,0,0,0
0,0,0,1,106,0,0,0,0
0,0,0,1,106,0,0,0,0
0,0,0,1,106,0,0,0,0
0,0,0,1,106,0,0,0,0
0,0,0,1,106,0,0,0,0
0,0,0,1,106,0,0,0,0
0,0,0,1,106,0,0,0,0
0,0,0,1,106,0,0,0,0
0,0,0,1,106,0,0,0,0
0,0,0,1,106,0,0,0,0
0,0,0,1,106,0,0,0,0
0,0,0,1,106,0,0,0,0
0,0,0,1,106,0,0,0,0
0,0,0,1,106,0,0,0,0
0,0,0,1,106,0,0,0,0
0,0,0,1,106,0,0,0,0
0,0,0,1,106,0,0,0,0
0,0,0,1,106,0,0,0,0
0,0,0,1,106,0,0,0,0
0,0,0,1,106,0,0,0,0
0,0,0,1,106,0,0,0,0
0,0,0,1,106,0,0,0,0
0,0,0,1,106,0,0,0,0
0,0,0,1,106,0,0,0,0
0,0,0,1,106,0,0,0,0
0,0,0,1,106,0,0,0,0
0,0,0,1,106,0,0,0,0
0,0,0,1,106,0,0,0,0
0,0,0,1,106,0,0,0,0
0,0,0,1,106,0,0,0,0
0,0,0,1,106,0,0,0,0
0,0,0,1,106,0,0,0,0
0,0,0,1,106,0,0,0,0
0,0,0,1,106,0,0,0,0
0,0,0,1,106,0,0,0,0
0,0,0,1,106,0,0,0,0
0,0,0,1,106,0,0,0,0
0,0,0,1,106,0,0,0,0
0,0,0,1,106,0,0,0,0
0,0,0,1,106,0,0,0,0
0,0,0,1,106,0,0,0,0
0,0,0,1,106,0,0,0,0
0,0,0,1,106,0,0,0,0
0,0,0,1,106,0,0,0,0
0,0,0,1,106,0,0,0,0
0,0,0,1,106,0,0,0,0
0,0,0,1,106,0,0,0,0
2,1,1,1,52,0,0,0,0
1,1,0,1,98,0,0,0,0
81,65,16,7,38,1,0,0,0
11,5,6,3,28,1,0,0,0
10,5,5,2,28,1,0,0,0
53,34,19,9,28,0,0,0,0
3,2,1,1,56,0,0,0,0
4,2,2,1,28,0,0,0,0
8,5,3,2,28,1,0,0,0
7,3,4,3,28,1,0,0,0
6,3,3,1,28,0,0,0,0
5,2,3,3,94,1,0,0,0
1,0,1,1,94,0,0,0,0
0,0,0,1,119,1,0,0,0
0,0,0,1,118,1,0,0,0
5,2,3,2,28,0,0,0,0
28,19,9,2,41,1,0,0,0
8,4,4,2,28,0,0,0,0
5,3,2,2,74,0,0,0,0
49,25,24,6,23,2,0,0,0
8,4,4,1,28,0,0,0,0
118,117,1,3,41,1,0,0,0
1,1,0,1,98,0,0,0,0
2,1,1,2,40,1,0,0,0
3,2,1,2,28,0,0,0,0
0,0,0,2,106,0,0,0,0
1,1,0,1,98,0,0,0,0
8,3,5,2,94,0,0,0,0
21,13,8,3,28,0,0,0,0
22,11,11,5,28,1,0,0,0
24,15,9,7,28,0,0,0,0
15,10,5,4,28,0,0,0,0
1,0,1,1,94,0,0,0,0
1,1,0,1,98,0,0,0,0
1,1,0,1,98,0,0,0,0
46,45,1,2,86,1,0,0,0
2,0,2,2,94,0,0,0,0
1,1,0,1,98,0,0,0,0
1,0,1,1,94,0,0,0,0
2,1,1,1,107,1,0,0,0
15,7,8,4,94,1,0,0,0
2,1,1,1,107,1,0,0,0
1,0,1,1,94,0,0,0,0
53,22,31,7,28,0,0,0,0
122,87,35,8,27,1,0,0,0
267,51,216,9,28,0,0,0,0
94,51,43,9,28,0,0,0,0
134,96,38,11,28,2,0,0,0
37,29,8,8,28,1,0,0,0
10,5,5,5,28,0,0,0,0
49,18,31,7,28,0,0,0,0
13,2,11,1,90,1,0,0,0
61,27,34,4,36,3,0,0,0
1,0,1,1,45,1,0,0,0
81,4,77,3,36,0,0,0,0
21,0,21,2,34,2,0,0,0
1023,158,865,3,36,0,0,0,0
36,27,9,4,4,2,0,0,0
73,43,30,9,28,2,0,0,0
7,3,4,3,94,1,0,0,0
5,2,3,1,85,0,0,0,0
3,2,1,2,28,0,0,0,0
12,6,6,2,28,1,0,0,0
27,15,12,10,28,1,0,0,0
7,5,2,6,28,0,0,0,0
15,10,5,6,85,0,0,0,0
20,11,9,4,85,1,0,0,0
1,0,1,1,94,0,0,0,0
12,12,0,5,85,0,0,0,0
0,0,0,1,36,0,0,0,0
20,17,3,2,36,0,0,0,0
13,8,5,5,94,0,0,0,0
0,0,0,1,95,0,0,0,0
0,0,0,1,95,0,0,0,0
0,0,0,1,95,0,0,0,0
9,5,4,5,85,0,0,0,0
1,1,0,3,77,0,0,0,0
0,0,0,1,95,0,0,0,0
12,12,0,1,39,0,0,0,0
0,0,0,1,95,0,0,0,0
2,1,1,1,28,0,0,0,0
4,2,2,1,28,0,0,0,0
25,11,14,4,28,1,0,0,0
6,3,3,1,28,0,0,0,0
24,14,10,4,34,1,0,0,0
15,9,6,3,34,1,0,0,0
2,1,1,1,28,0,0,0,0
2,1,1,1,28,0,0,0,0
144,75,69,4,34,1,0,0,0
21,14,7,2,80,0,0,0,0
124,94,30,5,31,1,0,0,0
15,12,3,2,31,0,0,0,0
89,57,32,7,34,2,0,0,0
6,4,2,2,94,0,0,0,0
26,17,9,5,53,2,0,0,0
12,8,4,1,94,0,0,0,0
4,2,2,2,94,1,0,0,0
26,18,8,3,28,0,0,0,0
31,22,9,1,90,0,0,0,0
8,6,2,2,77,1,0,0,0
29,18,11,2,88,0,0,0,0
7,4,3,2,116,0,0,0,0
16,9,7,1,89,0,0,0,0
21,10,11,3,101,1,0,0,0
26,19,7,3,80,1,0,0,0
2,1,1,1,94,0,0,0,0
4,2,2,2,28,1,0,0,0
13,8,5,5,28,1,0,0,0
22,13,9,4,34,1,0,0,0
41,25,16,4,34,1,0,0,0
69,41,28,3,41,0,0,0,0
0,0,0,1,103,0,0,0,0
10,9,1,3,103,0,0,0,0
32,23,9,3,105,2,0,0,0
0,0,0,1,105,0,0,0,0
0,0,0,1,104,0,0,0,0
35,33,2,3,45,1,0,0,0
2,1,1,3,100,2,0,0,0
7,3,4,3,100,1,0,0,0
0,0,0,1,101,0,0,0,0
0,0,0,1,104,0,0,0,0
0,0,0,1,105,0,0,0,0
0,0,0,1,98,0,0,0,0
192,1,191,3,80,0,0,0,0
21,11,10,3,25,1,0,0,0
23,11,12,2,94,1,0,0,0
2,1,1,2,98,1,0,0,0
30,0,30,2,98,0,0,0,0
0,0,0,1,98,0,0,0,0
510,423,87,11,4,2,0,0,0
0,0,0,1,105,0,0,0,0
0,0,0,1,106,0,0,0,0
36,19,17,7,25,1,0,0,0
50,30,20,10,1,2,0,0,0
10,5,5,2,85,1,0,0,0
34,23,11,10,28,1,0,0,0
0,0,0,1,89,0,0,0,0
9,5,4,3,85,0,0,0,0
23,17,6,3,39,0,0,0,0
62,35,27,5,28,0,0,0,0
26,17,9,3,28,0,0,0,0
96,85,11,7,18,1,0,0,0
7,4,3,3,0,0,0,0,0
19,9,10,4,41,1,0,0,0
0,0,0,1,98,0,0,0,0
12,2,10,2,105,1,0,0,0
2,1,1,1,107,1,0,0,0
1,1,0,1,98,0,0,0,0
7,4,3,3,98,1,0,0,0
2,1,1,1,107,1,0,0,0
9,5,4,1,116,0,0,0,0
2,1,1,1,107,1,0,0,0
2,1,1,1,107,1,0,0,0
4,2,2,2,28,1,0,0,0
1,0,1,1,94,0,0,0,0
8,4,4,2,28,0,0,0,0
11,6,5,2,9,0,0,0,0
2,1,1,1,28,0,0,0,0
2,1,1,1,28,0,0,0,0
2,1,1,1,28,0,0,0,0
0,0,0,1,41,0,0,0,0
0,0,0,1,41,0,0,0,0
0,0,0,1,41,0,0,0,0
14,4,10,2,41,0,0,0,0
3,1,2,3,41,0,0,0,0
0,0,0,1,41,0,0,0,0
0,0,0,1,41,0,0,0,0
11,0,11,2,41,0,0,0,0
0,0,0,1,41,0,0,0,0
0,0,0,1,41,0,0,0,0
0,0,0,1,41,0,0,0,0
0,0,0,1,41,0,0,0,0
0,0,0,2,41,1,0,0,0
0,0,0,1,41,0,0,0,0
8,8,0,2,41,0,0,0,0
2,1,1,1,28,0,0,0,0
2,1,1,1,28,0,0,0,0
17,9,8,3,28,1,0,0,0
18,16,2,6,52,1,0,0,0
1,1,0,1,98,0,0,0,0
2,1,1,1,107,1,0,0,0
4,2,2,1,34,0,0,0,0
6,3,3,1,34,0,0,0,0
171,100,71,1,28,0,0,0,0
6,3,3,2,28,1,0,0,0
6,1,5,1,28,0,0,0,0
8,3,5,2,28,1,0,0,0
4,3,1,2,28,0,0,0,0
2,1,1,1,107,1,0,0,0
5,4,1,4,28,1,0,0,0
4,2,2,2,28,1,0,0,0
2,2,0,1,39,1,0,0,0
2,1,1,1,107,1,0,0,0
2,1,1,1,107,1,0,0,0
2,1,1,1,107,1,0,0,0
22,11,11,1,28,0,0,0,0
2,1,1,1,107,1,0,0,0
4,2,2,2,28,1,0,0,0
8,5,3,2,90,1,0,0,0
64,61,3,2,19,0,0,0,0
85,59,26,4,34,1,0,0,0
6,3,3,2,28,1,0,0,0
44,40,4,1,19,0,0,0,0
2,1,1,1,94,0,0,0,0
199,186,13,1,19,0,0,0,0
9,4,5,4,94,0,0,0,0
8,4,4,2,28,1,0,0,0
4,2,2,1,28,0,0,0,0
2,1,1,1,107,1,0,0,0
2,1,1,1,107,1,0,0,0
4,2,2,1,28,0,0,0,0
2,1,1,1,107,1,0,0,0
4,2,2,1,94,0,0,0,0
1,1,0,1,98,0,0,0,0
2,1,1,1,107,1,0,0,0
13,9,4,4,85,1,0,0,0
33,24,9,5,23,1,0,0,0
5,2,3,3,28,2,0,0,0
7,4,3,2,28,1,0,0,0
16,8,8,2,28,1,0,0,0
17,14,3,4,28,2,0,0,0
4,2,2,1,28,0,0,0,0
1,0,1,1,94,0,0,0,0
8,3,5,4,94,2,0,0,0
225,159,66,22,10,4,0,0,0
30,27,3,1,94,0,0,0,0
42,27,15,9,10,0,0,0,0
4,2,2,4,36,1,0,0,0
191,111,80,6,36,2,0,0,0
6,3,3,2,35,1,0,0,0
222,56,166,11,10,4,0,0,0
2,1,1,2,35,1,0,0,0
8,4,4,2,28,1,0,0,0
13,3,10,2,28,0,0,0,0
2,1,1,1,28,0,0,0,0
4,2,2,1,28,0,0,0,0
2,1,1,1,28,0,0,0,0
8,4,4,2,28,0,0,0,0
20,0,20,1,36,0,0,0,0
3,2,1,1,35,1,0,0,0
25,24,1,2,51,0,0,0,0
16,12,4,1,86,0,0,0,0
26,3,23,3,28,0,0,0,0
8,2,6,2,89,1,0,0,0
201,137,64,11,28,5,0,0,0
16,10,6,5,28,2,0,0,0
18,15,3,3,85,0,0,0,0
129,106,23,6,98,0,0,0,0
2,1,1,1,28,0,0,0,0
3,3,0,1,20,0,0,0,0
3,1,2,2,107,2,0,0,0
403,285,118,19,90,5,0,0,0
2,1,1,1,107,1,0,0,0
10,9,1,2,118,0,0,0,0
155,115,40,9,28,2,0,0,0
370,246,124,18,28,3,0,0,0
7,4,3,3,85,1,0,0,0
423,226,197,31,48,4,0,0,0
124,77,47,5,83,2,0,0,0
80,34,46,6,28,2,0,0,0
34,21,13,2,25,1,0,0,0
478,237,241,23,86,2,0,0,0
1,0,1,1,94,0,0,0,0
18,9,9,3,97,1,0,0,0
14,8,6,1,86,0,0,0,0
0,0,0,1,90,0,0,0,0
0,0,0,1,110,0,0,0,0
2,1,1,1,95,0,0,0,0
4,3,1,2,86,1,0,0,0
4,3,1,1,119,0,0,0,0
6,0,6,1,118,1,0,0,0
33,23,10,4,7,1,0,0,0
0,0,0,1,118,0,0,0,0
7,5,2,1,19,0,0,0,0
0,0,0,1,37,0,0,0,0
0,0,0,1,37,0,0,0,0
1,1,0,1,98,0,0,0,0
2,2,0,1,94,0,0,0,0
57,29,28,10,18,5,0,0,0
59,47,12,3,36,1,0,0,0
0,0,0,1,94,0,0,0,0
0,0,0,1,94,0,0,0,0
16,10,6,1,36,1,0,0,0
4,2,2,1,36,1,0,0,0
1,1,0,2,17,0,0,0,0
169,113,56,21,7,6,0,0,0
157,119,38,4,36,1,0,0,0
14,7,7,1,36,1,0,0,0
0,0,0,1,4,0,0,0,0
6,3,3,2,97,1,0,0,0
28,25,3,2,36,0,0,0,0
2,1,1,1,34,1,0,0,0
2,1,1,1,36,1,0,0,0
0,0,0,1,110,0,0,0,0
0,0,0,2,110,0,0,0,0
0,0,0,2,110,0,0,0,0
0,0,0,2,110,0,0,0,0
0,0,0,2,110,0,0,0,0
0,0,0,2,110,0,0,0,0
11,6,5,4,110,0,0,0,0
55,41,14,8,5,3,0,0,0
7,3,4,3,94,1,0,0,0
2,1,1,1,107,1,0,0,0
2,1,1,1,107,1,0,0,0
2,1,1,1,85,0,0,0,0
3,1,2,2,94,0,0,0,0
18,9,9,4,94,0,0,0,0
4,2,2,2,85,1,0,0,0
2,1,1,1,107,1,0,0,0
3,1,2,2,94,0,0,0,0
2,1,1,1,85,0,0,0,0
2,1,1,1,85,0,0,0,0
10,10,0,1,52,0,0,0,0
6,4,2,3,28,1,0,0,0
2,1,1,1,28,0,0,0,0
21,17,4,4,28,2,0,0,0
2,1,1,1,107,1,0,0,0
3,1,2,2,94,0,0,0,0
3,2,1,2,28,0,0,0,0
19,10,9,2,28,0,0,0,0
18,9,9,2,28,0,0,0,0
16,8,8,2,28,0,0,0,0
23,12,11,2,28,0,0,0,0
28,14,14,2,28,0,0,0,0
34,15,19,5,23,1,0,0,0
6,3,3,2,28,1,0,0,0
10,6,4,4,5,1,0,0,0
73,44,29,5,23,1,0,0,0
8,4,4,3,28,1,0,0,0
9,4,5,3,23,0,0,0,0
6,3,3,3,28,1,0,0,0
17,9,8,2,85,0,0,0,0
4,2,2,2,5,1,0,0,0
2,1,1,1,107,1,0,0,0
24,10,14,3,85,0,0,0,0
2,1,1,1,94,0,0,0,0
23,18,5,1,50,1,0,0,0
16,12,4,1,39,1,0,0,0
2,1,1,1,107,1,0,0,0
10,7,3,6,28,1,0,0,0
28,14,14,2,94,0,0,0,0
8,6,2,2,85,0,0,0,0
15,7,8,2,94,0,0,0,0
34,22,12,8,28,1,0,0,0
111,56,55,3,103,0,0,0,0
2,1,1,1,107,1,0,0,0
2,1,1,1,107,1,0,0,0
0,0,0,1,41,1,0,0,0
2,1,1,1,107,1,0,0,0
6,4,2,1,80,0,0,0,0
14,10,4,3,31,0,0,0,0
26,13,13,1,34,1,0,0,0
9,6,3,2,89,1,0,0,0
9,7,2,2,80,0,0,0,0
20,14,6,4,80,0,0,0,0
2,2,0,2,106,0,0,0,0
45,26,19,7,28,2,0,0,0
95,56,39,4,28,0,0,0,0
111,62,49,8,28,2,0,0,0
2,1,1,1,107,1,0,0,0
42,21,21,1,116,0,0,0,0
9,5,4,2,9,0,0,0,0
12,6,6,1,40,0,0,0,0
42,23,19,3,94,1,0,0,0
6,3,3,2,100,1,0,0,0
4,2,2,2,89,0,0,0,0
16,8,8,5,98,3,0,0,0
2,1,1,1,94,0,0,0,0
293,273,20,6,79,2,0,0,0
93,87,6,3,39,0,0,0,0
14,10,4,6,28,0,0,0,0
35,25,10,2,85,0,0,0,0
1,0,1,1,94,0,0,0,0
6,5,1,2,85,0,0,0,0
18,11,7,6,28,1,0,0,0
3,1,2,2,34,1,0,0,0
1,0,1,1,94,0,0,0,0
40,21,19,3,94,0,0,0,0
5,2,3,2,28,0,0,0,0
48,47,1,2,44,0,0,0,0
17,10,7,5,28,1,0,0,0
91,80,11,7,28,2,0,0,0
1,0,1,1,94,0,0,0,0
1,1,0,1,84,1,0,0,0
1,0,1,1,94,0,0,0,0
80,80,0,1,84,1,0,0,0
976,941,35,10,17,2,0,0,0
13,8,5,5,34,2,0,0,0
1,0,1,1,94,0,0,0,0
44,37,7,2,88,0,0,0,0
2,2,0,2,51,0,0,0,0
214,124,90,6,101,2,0,0,0
179,97,82,3,94,0,0,0,0
193,107,86,6,95,2,0,0,0
2,1,1,1,28,0,0,0,0
2,0,2,1,95,0,0,0,0
320,259,61,11,5,2,0,0,0
2,2,0,1,98,0,0,0,0
4,2,2,1,103,0,0,0,0
20,14,6,4,85,1,0,0,0
459,290,169,18,94,3,0,0,0
11,8,3,2,94,0,0,0,0
2,1,1,1,85,1,0,0,0
952,854,98,32,34,5,0,0,0
42,41,1,3,71,0,0,0,0
8,5,3,2,97,0,0,0,0
6,3,3,1,41,0,0,0,0
6,3,3,1,41,0,0,0,0
41,31,10,2,85,0,0,0,0
12,8,4,7,49,1,0,0,0
3,1,2,1,71,0,0,0,0
344,239,105,24,53,4,0,0,0
89,62,27,5,86,1,0,0,0
3334,2370,964,52,20,9,0,0,0
31,22,9,5,80,0,0,0,0
282,179,103,17,77,1,0,0,0
78,51,27,7,34,2,0,0,0
12,7,5,3,85,2,0,0,0
2,1,1,1,94,0,0,0,0
465,324,141,18,88,1,0,0,0
241,202,39,11,17,3,0,0,0
20,14,6,5,60,1,0,0,0
25,13,12,7,10,4,0,0,0
51,25,26,4,94,2,0,0,0
1,0,1,1,94,0,0,0,0
1,0,1,1,94,0,0,0,0
2,0,2,1,94,0,0,0,0
1,0,1,1,94,0,0,0,0
1,0,1,1,94,0,0,0,0
32,19,13,3,85,1,0,0,0
2,1,1,1,107,1,0,0,0
11,8,3,3,85,1,0,0,0
94,13,81,6,35,3,0,0,0
4,2,2,2,66,1,0,0,0
6,4,2,4,35,3,0,0,0
12,8,4,4,85,1,0,0,0
17,8,9,5,45,2,0,0,0
12,6,6,3,28,1,0,0,0
24,16,8,8,24,4,0,0,0
17,8,9,1,96,0,0,0,0
35,22,13,5,34,1,0,0,0
2,1,1,1,107,0,0,0,0
6,4,2,3,28,0,0,0,0
2,1,1,1,28,0,0,0,0
4,2,2,3,28,1,0,0,0
0,0,0,1,110,0,0,0,0
42,20,22,6,28,0,0,0,0
1,1,0,1,94,1,0,0,0
6,3,3,2,28,1,0,0,0
24,12,12,5,18,3,0,0,0
2,1,1,1,28,0,0,0,0
2,1,1,1,28,0,0,0,0
28,22,6,3,82,0,0,0,0
5,3,2,2,90,0,0,0,0
0,0,0,1,31,0,0,0,0
3,2,1,2,31,0,0,0,0
4,2,2,1,31,1,0,0,0
0,0,0,1,11,0,0,0,0
11,7,4,2,90,0,0,0,0
20,13,7,6,20,1,0,0,0
3,1,2,2,28,0,0,0,0
11,8,3,1,90,0,0,0,0
123,114,9,7,11,0,0,0,0
21,7,14,6,4,0,0,0,0
12,4,8,2,52,1,0,0,0
2,1,1,1,28,0,0,0,0
0,0,0,1,52,0,0,0,0
2,1,1,1,107,1,0,0,0
1,0,1,1,40,0,0,0,0
4,2,2,1,28,0,0,0,0
4,2,2,2,28,1,0,0,0
4,2,2,1,28,0,0,0,0
2,1,1,1,18,0,0,0,0
44,41,3,1,98,0,0,0,0
115,102,13,4,41,1,0,0,0
0,0,0,1,4,0,0,0,0
0,0,0,1,4,0,0,0,0
0,0,0,1,4,0,0,0,0
0,0,0,1,4,0,0,0,0
0,0,0,1,4,0,0,0,0
0,0,0,1,4,0,0,0,0
0,0,0,1,4,0,0,0,0
0,0,0,1,4,0,0,0,0
0,0,0,1,4,0,0,0,0
0,0,0,1,4,0,0,0,0
7,5,2,1,7,1,0,0,435
0,0,0,1,99,0,0,0,431
