CODECHURN,LOCADDED,LOCDELETED,REVISIONS,AGE,BUGFIXES,REFACTORINGS,ERROR_DENSITY,LOC
0,0,0,1,70,0,0,0,57
0,0,0,1,70,0,0,0,39
0,0,0,1,70,0,0,0,8
0,0,0,1,70,0,0,0,12
4,2,2,2,68,1,0,0,19
0,0,0,1,70,0,0,0,0
0,0,0,1,70,0,0,0,0
0,0,0,1,70,0,0,0,0
0,0,0,1,70,0,0,0,0
0,0,0,1,70,0,0,0,0
8,0,8,1,54,0,0,0.00137174211248285,729
7,0,7,1,54,0,0,0,691
13,12,1,1,8,0,0,0,82
48,34,14,1,32,1,0,0,264
3,3,0,1,8,0,0,0,310
85,37,48,7,46,1,0,0.0294117647058824,102
0,0,0,1,52,0,0,0,4
2,1,1,3,52,1,0,0,0
0,0,0,2,52,0,0,0,0
2,1,1,1,83,1,0,0,550
2,1,1,1,56,0,0,0,174
24,12,12,4,56,3,0,0,477
5,3,2,2,56,1,0,0,214
8,4,4,3,7,3,0,0,450
22,13,9,2,32,1,0,0.00214592274678112,466
315,223,92,13,5,6,0,0.000485436893203883,2060
9,6,3,2,56,1,0,0,155
18,11,7,2,62,2,0,0,500
6,3,3,1,14,0,0,0.0147058823529412,68
75,46,29,11,14,6,0,0.000804181745074387,4974
407,1,406,4,37,1,0,0,0
12,1,11,2,14,2,0,0,1921
277,154,123,7,4,3,0,0.00346981263011797,1441
1611,798,813,8,32,4,0,0.00320512820512821,624
22,20,2,1,95,0,0,0.00124223602484472,805
2,2,0,1,112,1,0,0,33
3,2,1,1,95,1,0,0.00144927536231884,690
705,372,333,14,88,6,0,0.00403225806451613,744
21,12,9,2,4,0,0,0.00498753117206983,401
0,0,0,1,71,0,0,0,0
2,2,0,1,67,1,0,0,122
2,1,1,1,79,1,0,0,61
130,89,41,2,3,1,0,0,96
25,16,9,3,12,2,0,0,141
1,0,1,1,96,0,0,0,39
49,30,19,13,50,1,3,0.00809716599190283,247
41,39,2,5,95,1,0,0,97
8,8,0,1,4,1,0,0,240
50,34,16,12,5,1,0,0.00347222222222222,288
16,3,13,1,94,1,0,0.0204081632653061,49
59,30,29,13,1,3,0,0.000771010023130301,1297
36,10,26,2,8,1,0,0.000716332378223496,2792
3,3,0,1,85,0,0,0,256
9,9,0,3,35,1,0,0,238
2,1,1,1,9,1,0,0,75
2,2,0,1,76,0,0,0,628
6,3,3,1,20,1,0,0,115
30,4,26,8,7,2,0,0,406
1,1,0,1,90,0,0,0,571
2,1,1,1,62,0,0,0,175
7,1,6,2,12,1,0,0,96
1,0,1,1,63,0,0,0,400
1,1,0,1,57,1,0,0,56
185,123,62,43,0,10,0,0,0
2,1,1,1,79,0,0,0,165
16,7,9,4,39,1,0,0,120
53,43,10,3,75,1,0,0,321
62,0,62,7,96,1,0,0,0
10,7,3,1,97,1,0,0,492
9,5,4,1,57,1,0,0,2224
819,0,819,14,102,1,0,0,0
16,0,16,1,103,0,0,0,275
90,37,53,29,4,5,0,0.00254971953085161,1961
5,3,2,2,12,0,0,0,398
10,9,1,2,5,2,0,0,227
4,0,4,1,54,0,0,0,870
61,44,17,6,97,1,0,0,108
19,7,12,2,22,1,0,0,699
17,7,10,3,22,2,0,0,402
4,2,2,2,97,0,0,0,246
26,21,5,1,117,1,0,0,415
96,69,27,3,91,0,0,0.00441501103752759,453
12,6,6,1,79,1,0,0,430
10,4,6,2,48,0,0,0,300
114,110,4,2,3,1,0,0,98
293,169,124,2,63,1,0,0.00104275286757039,1918
0,0,0,1,39,0,0,0,0
0,0,0,1,39,0,0,0,0
9,6,3,2,7,0,0,0.00159616919393456,1253
22,22,0,1,67,0,0,0,158
76,74,2,3,78,1,0,0.00480769230769231,208
10,10,0,1,113,0,0,0.0175097276264591,514
20,16,4,2,12,1,0,0,390
24,24,0,1,113,0,0,0,358
6,3,3,2,79,1,0,0,1265
231,213,18,11,85,4,0,0.00701754385964912,285
12,7,5,2,0,2,0,0.00183654729109275,1089
6,3,3,3,20,1,0,0,426
5,5,0,1,18,0,0,0,218
2,1,1,1,55,0,0,0,506
18,13,5,3,8,1,0,0,459
2,1,1,1,102,1,0,0,1084
10,4,6,1,100,1,0,0,330
39,34,5,1,42,1,0,0,417
6,4,2,2,7,0,0,0,363
33,31,2,4,18,2,0,0,159
32,17,15,1,44,1,0,0.00230414746543779,434
10,5,5,2,8,0,0,0.00602409638554217,166
5,3,2,1,63,1,0,0,237
128,121,7,7,72,1,0,0.00529100529100529,189
9,8,1,3,79,1,0,0,65
0,0,0,1,84,0,0,0,11
18,15,3,2,56,0,0,0,101
45,37,8,1,84,0,0,0,86
77,34,43,2,84,0,0,0,95
0,0,0,1,34,0,0,0,0
0,0,0,1,29,0,0,0,0
0,0,0,1,33,0,0,0,0
0,0,0,1,29,0,0,0,0
0,0,0,1,0,0,0,0,0
0,0,0,1,29,1,0,0,0
0,0,0,1,29,0,0,0,0
0,0,0,1,29,0,0,0,0
0,0,0,1,29,0,0,0,0
0,0,0,1,29,0,0,0,0
0,0,0,1,29,0,0,0,0
693,509,184,13,26,7,0,0.00173110213502597,1733
96,39,57,1,84,0,0,0,102
0,0,0,1,14,0,0,0,0
0,0,0,1,83,1,0,0,103
0,0,0,1,6,0,0,0,0
0,0,0,1,83,0,0,0,82
0,0,0,1,79,1,0,0.0102040816326531,98
2,1,1,2,22,1,0,0,100
310,122,188,7,54,0,0,0.00578034682080925,173
1847,1413,434,15,0,2,0,0,0
635,176,459,11,7,2,0,0.00433839479392625,461
841,840,1,18,0,1,0,0,639
148,148,0,17,0,1,0,0,114
1148,903,245,13,28,3,0,0,0
73,67,6,11,0,2,0,0,291
837,745,92,26,0,1,0,0.0173160173160173,462
50,43,7,6,0,1,0,0.111111111111111,36
69,55,14,4,28,1,0,0,0
328,123,205,17,25,5,0,0,205
1497,1104,393,16,0,2,0,0.0155642023346304,1028
35,6,29,2,57,2,0,0,539
39,20,19,1,95,0,0,0,464
31,29,2,2,42,1,0,0,233
10,5,5,2,53,2,0,0,222
22,13,9,2,109,0,0,0,33
2,1,1,2,105,0,0,0,39
66,28,38,5,55,0,0,0.00163132137030995,613
21,18,3,5,55,0,0,0,582
2,1,1,1,108,0,0,0.00065359477124183,1530
0,0,0,1,105,0,0,0,46
16,15,1,4,54,0,0,0,332
15,15,0,1,55,0,0,0,69
9,8,1,1,96,1,0,0,124
145,145,0,1,55,0,0,0,1080
57,40,17,1,113,0,0,0,78
112,83,29,8,77,3,0,0.00246913580246914,405
2115,765,1350,35,69,10,2,0,388
201,120,81,25,70,5,0,0,114
4,2,2,2,70,0,0,0.0105263157894737,95
92,75,17,17,70,2,0,0,85
684,544,140,35,8,4,1,0,1147
54,28,26,5,69,0,0,0,641
411,265,146,23,70,4,0,0,0
70,59,11,8,0,1,0,0,151
221,205,16,14,70,1,1,0,283
55,44,11,3,28,3,0,0.000550964187327824,1815
2,1,1,1,109,1,0,0,118
643,441,202,5,21,3,0,0.000626174076393237,1597
3,3,0,2,21,1,0,0,133
5,2,3,2,21,1,0,0,0
68,45,23,9,12,6,0,0,910
5,5,0,1,34,1,0,0,2492
12,10,2,2,4,2,0,0.000577367205542725,1732
3,2,1,1,75,0,0,0,1151
24,17,7,2,42,2,0,0,348
19,15,4,3,11,2,0,0,1472
132,125,7,9,0,4,0,0.000863557858376511,3474
4,1,3,1,54,0,0,0,69
30,0,30,3,81,1,0,0,112
92,75,17,2,63,1,0,0,221
9,8,1,1,88,0,0,0.00133155792276964,751
79,28,51,5,34,4,0,0.00143334925943622,2093
76,48,28,3,27,2,0,0.00104347826086957,2875
48,19,29,6,80,1,0,0,1481
20,11,9,1,63,1,0,0.000908265213442325,1101
16,10,6,2,54,1,0,0,417
1,1,0,1,117,1,0,0,377
277,164,113,7,26,1,0,0.00271739130434783,368
40,33,7,2,3,1,0,0,1011
26,23,3,5,7,4,0,0.00099304865938431,1007
96,58,38,4,1,0,0,0.00131061598951507,763
21,9,12,4,13,2,0,0,576
17,14,3,1,109,1,0,0.00122100122100122,819
415,346,69,17,4,7,0,0.000825309491059147,3635
31,20,11,5,63,2,0,0,364
2,2,0,1,100,1,0,0,1127
2,2,0,1,33,0,0,0.00884955752212389,113
0,0,0,1,76,0,0,0,353
2,1,1,2,73,1,0,0.00159744408945687,626
23,16,7,1,63,1,0,0,0
0,0,0,1,79,0,0,0,0
16,8,8,2,63,2,0,0,245
2,1,1,1,105,0,0,0,866
93,22,71,8,75,4,0,0,0
205,146,59,2,75,0,0,0,707
4,3,1,4,5,1,0,0,26
0,0,0,1,106,1,0,0,0
0,0,0,1,106,1,0,0,0
174,168,6,7,4,0,0,0,0
10,10,0,5,4,0,0,0,0
0,0,0,1,4,0,0,0,0
487,365,122,30,7,10,0,0.00203045685279188,1970
15,8,7,3,1,0,0,0,0
0,0,0,1,5,0,0,0,0
67,47,20,9,5,0,0,0,0
339,281,58,11,4,3,0,0.0160427807486631,187
91,48,43,11,4,1,0,0,0
7,4,3,2,4,0,0,0,0
226,50,176,5,4,2,0,0,0
15,10,5,5,4,1,0,0,0
2,1,1,2,4,0,0,0,0
132,66,66,1,98,0,0,0,1122
132,66,66,1,98,0,0,0,138
9,5,4,2,21,0,0,0,0
7,4,3,2,21,0,0,0,0
4,2,2,1,98,0,0,0,476
4,2,2,1,98,0,0,0,39
42,21,21,2,77,1,0,0,420
38,19,19,1,98,0,0,0,43
52,26,26,2,77,1,0,0,355
48,24,24,1,98,0,0,0,44
44,22,22,2,77,1,0,0,939
42,21,21,1,98,0,0,0,73
24,12,12,1,98,0,0,0.00632911392405063,158
24,12,12,1,98,0,0,0.04,25
430,211,219,4,84,0,0,0,3483
414,207,207,4,84,0,0,0,370
486,243,243,3,96,0,0,0,2385
486,243,243,3,96,0,0,0,361
57,37,20,3,77,1,0,0,2783
45,26,19,2,97,0,0,0,218
502,251,251,2,70,0,0,0,3030
502,251,251,2,70,0,0,0,389
429,205,224,11,77,3,0,0,2695
389,192,197,10,98,2,0,0,347
428,213,215,3,77,1,0,0,2291
402,201,201,2,98,0,0,0,336
250,125,125,3,77,1,0,0.00056785917092561,1761
242,121,121,2,98,0,0,0.00436681222707424,229
266,133,133,1,98,0,0,0,1601
266,133,133,1,98,0,0,0,230
4,3,1,1,63,0,0,0,579
0,0,0,1,5,0,0,0,0
58,54,4,5,7,0,0,0,0
50,41,9,4,117,0,0,0.0072992700729927,137
7,7,0,3,46,0,0,0.0128205128205128,78
407,407,0,20,0,4,0,0.00714285714285714,280
18,12,6,5,84,0,0,0,1647
11,11,0,1,92,0,0,0,32
113,88,25,9,35,1,0,0.00121951219512195,820
3,2,1,2,63,0,0,0,5801
0,0,0,1,5,0,0,0,0
0,0,0,1,5,0,0,0,0
457,424,33,5,7,0,0,0,0
2,2,0,2,37,0,0,0,0
2,1,1,1,86,0,0,0,1082
2,1,1,1,86,0,0,0,1513
2,1,1,1,86,0,0,0,2699
317,211,106,4,117,0,0,0.00110864745011086,902
5,3,2,3,117,0,0,0,55
13,13,0,3,46,0,0,0.00862068965517241,116
955,955,0,19,0,4,0,0.00227014755959137,881
190,152,38,19,0,4,0,0.0202020202020202,99
377,275,102,6,84,0,0,0,12547
3,3,0,1,96,0,0,0,383
81,81,0,1,92,0,0,0,195
3,3,0,1,92,0,0,0,19
1003,835,168,10,35,1,0,0.000208029956313709,4807
10,10,0,6,53,1,0,0,97
343,203,140,8,71,0,0,0,15105
13,10,3,4,95,0,0,0,261
153,153,0,1,97,0,0,0,3616
60,43,17,3,70,0,0,0,12702
785,396,389,12,86,2,0,0,19654
4,4,0,4,113,0,0,0,315
113,87,26,3,86,0,0,0,6018
2,2,0,1,97,0,0,0,153
21,17,4,2,86,0,0,0.000220167327168648,4542
2,1,1,1,86,0,0,0,10679
108,76,32,8,62,0,0,0,1610
14,14,0,1,97,0,0,0,568
8,4,4,2,70,0,0,0,1759
1,1,0,1,75,0,0,0,327
10,5,5,3,84,0,0,0,6375
10,10,0,1,97,0,0,0,4859
19,7,12,6,113,1,0,0,4199
2,1,1,1,103,0,0,0,3621
69,39,30,11,92,2,0,0,1793
27,23,4,2,97,0,0,0,762
2,1,1,1,99,0,0,0.0016025641025641,624
14,14,0,2,39,0,0,0.00284900284900285,351
4,2,2,1,96,0,0,0,1101
4,2,2,1,74,0,0,0,859
0,0,0,1,39,0,0,0,0
0,0,0,1,39,0,0,0,0
5,1,4,3,35,1,0,0,0
0,0,0,1,39,0,0,0,0
26,26,0,1,75,0,0,0,117
157,76,81,2,42,2,0,0.00134589502018843,743
41,41,0,1,75,0,0,0,230
1,1,0,2,66,1,0,0,0
63,52,11,5,75,1,0,0,0
15,10,5,3,75,0,0,0,0
0,0,0,1,77,0,0,0,0
224,161,63,3,32,1,0,0,519
117,59,58,1,116,0,0,0.0103305785123967,484
99,66,33,10,29,6,0,0.000496524329692155,2014
62,59,3,3,72,1,0,0,1125
510,373,137,9,48,2,0,0.00280112044817927,357
155,17,138,5,0,2,1,0.00140845070422535,710
109,77,32,5,5,2,0,0.0034944670937682,1717
14,7,7,2,42,2,0,0.00158856235107228,1259
2,1,1,1,90,0,0,0.000374251497005988,2672
150,31,119,9,34,6,0,0.00280112044817927,714
12,12,0,1,85,1,0,0.00166666666666667,600
17,17,0,2,49,2,0,0.00142247510668563,703
347,206,141,3,26,2,0,0.00523560209424084,191
26,26,0,11,5,0,0,0.00543478260869565,184
1661,1086,575,41,14,8,0,0.0020703933747412,1449
10,5,5,3,106,2,0,0.00490196078431373,612
780,393,387,4,72,0,0,0,1948
30,22,8,2,106,1,0,0.00142857142857143,700
2,1,1,1,72,0,0,0.000434593654932638,2301
25,21,4,4,26,3,0,0,2145
2,1,1,1,71,0,0,0,247
1,1,0,1,90,0,0,0,759
8,5,3,1,62,0,0,0,1249
21,10,11,3,6,0,1,0.00390625,256
5,2,3,2,71,1,0,0.0036231884057971,276
79,74,5,1,49,1,0,0,1004
148,134,14,5,8,2,0,0,788
8,4,4,4,71,3,1,0.00395256916996047,253
7,6,1,2,81,0,0,0,1807
150,108,42,5,35,1,0,0.00201207243460765,1491
3,1,2,1,15,0,0,0.00126903553299492,788
10,0,10,1,54,0,0,0,1091
3,2,1,2,81,0,0,0,730
14,2,12,3,12,1,0,0.00183150183150183,546
6,5,1,1,100,1,0,0,307
2,1,1,1,72,1,0,0,196
15,0,15,1,54,0,0,0,639
15,3,12,2,54,1,0,0.00261096605744125,383
12,0,12,1,54,0,0,0.000636132315521629,1572
12,5,7,5,12,0,0,0,217
6,5,1,1,100,1,0,0,370
18,8,10,2,12,0,0,0,79
4,2,2,2,64,0,0,0,288
71,43,28,8,12,3,0,0.000897263346792284,2229
9,0,9,1,54,0,0,0,886
0,0,0,1,64,0,0,0,0
6,6,0,2,117,2,0,0,304
13,6,7,5,12,0,0,0,605
8,0,8,1,54,0,0,0,637
48,38,10,3,84,1,0,0.00508905852417303,393
10,0,10,1,54,0,0,0.00389105058365759,257
7,6,1,2,69,1,0,0,365
137,92,45,9,7,4,0,0.00100603621730382,994
4,2,2,1,71,0,0,0.0016260162601626,615
32,22,10,1,82,1,0,0.00257731958762887,388
9,5,4,1,92,0,0,0,45
151,150,1,2,81,1,0,0.00236406619385343,423
130,116,14,11,14,5,0,0.00210970464135021,474
80,71,9,3,16,2,0,0.00228310502283105,438
332,287,45,9,4,4,0,0.00753012048192771,664
466,452,14,8,49,2,0,0.00202429149797571,494
33,30,3,4,39,2,0,0,159
161,145,16,18,39,4,0,0,453
868,441,427,7,20,3,0,0.00145507457257184,2749
33,21,12,2,89,1,0,0.004739336492891,211
0,0,0,1,81,0,0,0,0
965,528,437,28,35,7,0,0.000590667454223272,1693
4,1,3,2,86,1,0,0,1477
39,39,0,1,22,1,0,0,442
14,12,2,3,56,3,0,0,414
3,1,2,1,117,0,0,0,144
3,1,2,1,117,0,0,0,256
4,1,3,1,117,0,0,0,358
216,108,108,1,113,0,0,0,629
4545,3922,623,49,6,18,2,0.000745553307061455,9389
28,14,14,2,98,0,0,0,590
22,12,10,2,56,2,0,0.00278357689631176,1437
26,24,2,1,91,0,0,0,248
48,32,16,6,36,2,0,0,1641
8,0,8,1,63,0,0,0,1089
114,78,36,6,63,6,0,0.000472738733060195,6346
6,4,2,1,109,1,0,0,1718
644,322,322,5,77,2,0,0.000610500610500611,1638
414,175,239,15,24,4,0,0,1365
80,41,39,1,21,1,0,0,1152
174,116,58,9,7,5,0,0,5894
8,3,5,2,7,0,0,0,124
115,63,52,7,7,3,0,0.000347222222222222,2880
1,0,1,1,54,0,0,0,459
40,31,9,3,79,1,0,0,1247
2,1,1,1,112,1,0,0,81
1281,787,494,75,54,3,2,0.00188501413760603,1061
9,4,5,3,100,3,0,0,1268
192,1,191,1,89,0,0,0,85
194,106,88,12,79,4,1,0,147
41,20,21,1,79,0,0,0,245
50,30,20,6,79,0,1,0,55
84,43,41,13,79,0,1,0,105
87,47,40,12,79,1,1,0,104
5,4,1,1,102,1,0,0,1372
43,36,7,2,56,0,0,0,248
7,5,2,2,100,2,0,0,1915
99,55,44,5,73,3,0,0,571
35,22,13,6,72,3,1,0.00470957613814757,637
2010,1328,682,42,5,11,3,0.00146198830409357,2736
163,121,42,6,6,0,0,0,271
18,9,9,2,71,0,0,0,2052
473,0,473,5,113,0,0,0,0
36,0,36,1,103,1,0,0,201
173,173,0,1,45,0,0,0,220
11,6,5,2,4,1,0,0.00216450216450216,462
328,322,6,7,91,3,0,0,402
7,2,5,2,72,1,0,0.0106382978723404,94
14,9,5,3,100,3,0,0,508
74,18,56,2,96,2,0,0,1834
2,1,1,1,109,1,0,0.000537634408602151,1860
239,47,192,8,39,1,0,0,849
11,8,3,3,68,3,0,0,7727
3473,0,3473,13,102,1,0,0,0
56,0,56,1,103,0,0,0,591
23,4,19,3,9,0,0,0,543
7,5,2,1,117,1,0,0,223
2,0,2,1,100,1,0,0,742
10,2,8,2,7,0,0,0,277
72,46,26,12,7,9,0,0.00164609053497942,2430
248,34,214,6,7,3,0,0.000628535512256443,1591
26,13,13,1,97,0,0,0,778
119,67,52,11,7,4,0,0.000411692054343351,2429
61,26,35,9,7,3,0,0.00157109190887667,1273
383,301,82,10,7,6,0,0.000503862949277796,5954
27,17,10,2,22,0,0,0,382
92,58,34,11,3,6,0,0.000100623867981485,9938
403,22,381,17,102,3,0,0,0
2242,1093,1149,36,8,11,0,0.000757575757575758,2640
18,1,17,1,103,1,0,0,287
23,10,13,3,96,2,0,0,1114
29,18,11,5,18,4,0,0.00207253886010363,965
72,32,40,6,7,1,0,0,496
2,2,0,1,102,1,0,0,329
276,233,43,7,20,3,0,0,0
49,34,15,4,71,2,0,0.00218023255813953,1376
40,21,19,2,73,0,0,0.000968992248062015,1032
371,261,110,9,6,1,0,0.000374672161858374,2669
180,89,91,7,5,4,0,0,2788
746,582,164,19,63,4,0,0,896
10,6,4,2,72,0,0,0,67
19,9,10,2,63,1,0,0,171
65,46,19,9,21,5,1,0,935
2,1,1,1,14,0,0,0,86
4,2,2,1,91,0,0,0,296
0,0,0,1,44,0,0,0,43
70,35,35,3,22,1,0,0,45
8,4,4,1,91,0,0,0,125
43,27,16,7,14,1,0,0.00308641975308642,324
6,3,3,1,91,0,0,0,333
7,5,2,3,81,0,0,0,29
2,1,1,2,12,1,0,0,50
156,110,46,11,12,3,0,0.00678733031674208,442
15,11,4,4,56,0,0,0,33
9,7,2,4,56,0,0,0,84
0,0,0,1,12,0,0,0.0222222222222222,90
10,5,5,2,56,0,0,0,50
164,118,46,9,12,0,0,0.0217391304347826,92
29,17,12,3,13,3,0,0.00134048257372654,746
5,3,2,2,73,1,1,0,99
13,9,4,2,73,2,0,0,1208
140,112,28,6,35,1,0,0,788
103,41,62,10,17,2,0,0.00289017341040462,346
8,4,4,2,12,0,0,0.00301204819277108,332
2,1,1,1,64,0,0,0,223
106,25,81,7,13,1,0,0,1383
26,25,1,2,78,0,0,0,340
42,28,14,1,111,0,0,0.00152905198776758,654
80,37,43,4,12,1,0,0,167
87,62,25,7,12,1,0,0,185
68,45,23,2,85,0,0,0.00216684723726977,923
18,13,5,1,91,0,0,0.00209205020920502,956
30,3,27,2,60,0,0,0.00364963503649635,548
187,101,86,3,64,0,0,0.00246913580246914,810
177,102,75,15,7,4,0,0,4615
11,7,4,1,63,1,0,0,692
13,6,7,1,63,1,0,0,310
321,181,140,15,9,10,0,0,1686
5,3,2,1,63,1,0,0,690
8,7,1,2,14,1,0,0,518
29,9,20,1,94,1,0,0,258
186,83,103,15,12,2,0,0.00138504155124654,2888
107,30,77,9,7,1,0,0.000956632653061224,3136
11,7,4,2,35,1,0,0,897
2,1,1,1,0,1,0,0,301
48,2,46,1,34,1,0,0,249
189,74,115,11,12,3,1,0,870
154,70,84,7,12,2,0,0.000463821892393321,4312
124,74,50,9,34,5,0,0.0014367816091954,2088
188,123,65,14,7,4,0,0.00097888407215774,7151
8,5,3,2,85,1,0,0.00134770889487871,742
2,1,1,1,12,0,0,0,476
150,110,40,12,8,3,0,0.00343406593406593,1456
627,274,353,26,5,4,0,0,1439
12,6,6,4,12,2,0,0.00303951367781155,329
115,60,55,12,42,9,0,0.000547945205479452,1825
26,15,11,1,51,0,0,0,276
352,213,139,16,12,4,0,0.000383631713554987,7820
334,177,157,21,12,4,1,0,435
4,4,0,1,99,1,0,0.00158982511923688,629
6,3,3,1,64,0,0,0,968
0,0,0,1,46,0,0,0,0
3,0,3,1,70,0,0,0,487
6,0,6,2,38,0,0,0,0
5,3,2,1,63,1,0,0,54
9,6,3,1,115,0,0,0.000176803394625177,5656
1,0,1,1,54,0,0,0,612
2,1,1,1,79,1,0,0,229
1565,582,983,22,10,5,0,0,1178
320,168,152,16,7,3,0,0.0072992700729927,137
1318,816,502,26,7,10,0,0.000878734622144112,2276
487,342,145,5,24,1,0,0,498
29,21,8,3,24,2,0,0,0
0,0,0,1,48,0,0,0,0
202,126,76,4,24,1,0,0,323
1269,734,535,30,24,8,0,0,1058
2,1,1,1,62,1,0,0,210
160,80,80,6,24,1,0,0.00387596899224806,258
0,0,0,1,49,0,0,0,0
0,0,0,1,49,0,0,0,0
356,221,135,6,24,1,0,0,820
371,76,295,15,24,1,0,0,289
0,0,0,1,50,0,0,0,0
0,0,0,1,50,0,0,0,0
250,193,57,7,24,2,0,0,378
0,0,0,1,49,0,0,0,0
60,25,35,4,47,1,0,0,447
180,97,83,21,13,3,0,0,0
1165,713,452,10,24,2,0,0.000896860986547085,1115
253,127,126,14,24,3,2,0,483
67,50,17,4,47,0,1,0,120
10,6,4,4,47,0,1,0,41
5039,2795,2244,43,3,15,0,0.000287811195855519,6949
140,106,34,3,24,1,0,0,422
60,34,26,8,41,2,0,0,496
793,411,382,6,50,0,0,0,2483
566,384,182,19,24,5,1,0.000841750841750842,1188
239,138,101,5,24,1,0,0,671
4519,1265,3254,35,4,8,0,0.000412881915772089,2422
263,172,91,6,24,2,0,0,644
94,56,38,3,53,0,0,0,435
70,37,33,4,41,0,0,0,284
660,461,199,8,14,4,0,0,1676
0,0,0,1,48,0,0,0,0
105,74,31,6,24,1,0,0,226
132,89,43,6,24,2,0,0,192
0,0,0,1,49,0,0,0,0
177,102,75,5,24,1,0,0,1046
631,563,68,12,10,3,0,0.0123456790123457,81
29,16,13,2,50,0,0,0,224
77,44,33,2,86,1,0,0,2491
5,4,1,1,63,1,0,0,604
0,0,0,1,44,0,0,0,0
0,0,0,1,44,0,0,0,0
3,2,1,1,109,1,0,0,62
22,15,7,2,57,1,0,0.00193610842207164,1033
14,0,14,1,43,0,0,0,1416
15,14,1,1,57,1,0,0,617
6,4,2,1,34,1,0,0,287
73,51,22,6,109,4,0,0,644
48,30,18,4,57,1,0,0,331
30,24,6,3,18,2,0,0,481
2,0,2,1,54,0,0,0,543
25,15,10,5,47,2,0,0,414
4,2,2,1,28,1,0,0,672
3,2,1,1,63,1,0,0.00221238938053097,452
30,18,12,4,28,3,0,0.000675219446320054,1481
0,0,0,1,44,0,0,0,0
78,74,4,3,14,3,0,0.00442757748260595,1581
21,5,16,1,97,0,0,0.00936329588014981,534
5,2,3,1,32,1,0,0.0235294117647059,170
131,77,54,11,0,4,0,0.00156617071260767,1277
16,15,1,3,5,1,0,0,381
85,53,32,3,41,2,0,0.00223214285714286,1344
182,170,12,4,0,4,0,0.000888888888888889,1125
118,84,34,10,0,2,0,0.000250752256770311,3988
451,168,283,30,4,12,0,0.00346170488965816,2311
8,8,0,2,5,2,0,0,119
87,67,20,10,0,8,0,0.00500834724540901,1198
261,92,169,7,1,6,0,0.00118976799524093,1681
56,49,7,3,49,1,0,0,103
249,230,19,4,5,2,0,0.00124223602484472,805
25,14,11,2,32,1,0,0,156
184,134,50,10,6,2,0,0.00162999185004075,2454
551,407,144,3,6,2,0,0.00272108843537415,735
39,28,11,5,0,4,0,0,0
4,2,2,1,73,0,0,0.000856898029134533,1167
94,1,93,1,5,1,0,0.00255102040816327,784
82,27,55,5,11,3,0,0.00330687830687831,1512
25,16,9,5,57,1,0,0,0
59,58,1,1,90,0,0,0,0
6,5,1,2,38,0,0,0,0
1,1,0,2,57,0,0,0,0
1,1,0,2,57,0,0,0,0
3,2,1,3,57,0,0,0,0
494,171,323,2,57,0,0,0,0
3,2,1,3,57,0,0,0,0
1,1,0,2,57,0,0,0,0
2,1,1,2,57,0,0,0,0
2,2,0,2,57,0,0,0,0
65,46,19,1,39,0,0,0,0
112,38,74,3,57,1,0,0,0
143,136,7,4,57,1,0,0,0
103,102,1,5,38,1,0,0,0
33,19,14,4,17,0,0,0,0
104,66,38,6,4,0,0,0,0
15,13,2,2,75,0,0,0,0
56,54,2,2,57,1,0,0,0
348,270,78,4,40,1,0,0,0
4,3,1,2,41,1,0,0,0
1,1,0,1,90,0,0,0,0
75,35,40,3,71,1,0,0,0
92,91,1,1,90,0,0,0,0
16,11,5,3,75,0,0,0,0
18,13,5,3,75,0,0,0,0
7,5,2,2,75,0,0,0,0
12,8,4,2,17,0,0,0,0
1,1,0,1,90,0,0,0,0
1,1,0,1,90,0,0,0,0
11,6,5,2,90,0,0,0,0
4,2,2,3,52,1,0,0,0
2,1,1,2,57,1,0,0,0
2,1,1,2,57,1,0,0,0
0,0,0,1,57,0,0,0,0
0,0,0,1,57,0,0,0,0
2,1,1,2,57,1,0,0,0
0,0,0,1,57,0,0,0,0
4,2,2,3,56,2,0,0,0
0,0,0,1,57,0,0,0,0
2,1,1,2,57,1,0,0,0
0,0,0,1,57,0,0,0,0
0,0,0,1,57,0,0,0,0
0,0,0,1,57,0,0,0,0
0,0,0,1,57,0,0,0,0
0,0,0,1,57,0,0,0,0
4,3,1,2,57,1,0,0,0
1,1,0,1,90,0,0,0,0
6,3,3,1,4,0,0,0,0
6,4,2,3,57,1,0,0,0
4,2,2,1,90,0,0,0,0
0,0,0,1,57,0,0,0,0
13,7,6,4,75,0,0,0,0
19,12,7,2,75,0,0,0,0
42,39,3,4,15,2,0,0,0
7,4,3,1,68,1,0,0,0
2,1,1,1,41,0,0,0,0
0,0,0,1,78,0,0,0,0
0,0,0,1,78,0,0,0,0
55,18,37,13,31,2,0,0,0
4,2,2,1,68,0,0,0,0
12,1,11,2,77,0,0,0,0
84,31,53,13,4,5,0,0,0
48,31,17,12,4,4,0,0,0
199,69,130,28,5,8,0,0,0
92,21,71,7,34,3,0,0,0
3,0,3,1,21,0,0,0,0
0,0,0,1,46,0,0,0,0
4,2,2,2,1,0,0,0,0
2,2,0,1,95,1,0,0,0
329,214,115,5,41,2,0,0,0
19,12,7,2,17,1,0,0,0
2,2,0,1,71,1,0,0,0
12,8,4,1,71,1,0,0,0
70,45,25,6,17,2,0,0,0
0,0,0,1,5,0,0,0,0
0,0,0,1,5,0,0,0,0
2,1,1,1,17,0,0,0,0
2,1,1,1,75,0,0,0,0
158,34,124,6,77,2,0,0,0
2,1,1,1,17,0,0,0,0
2,1,1,1,17,0,0,0,0
2,1,1,1,17,0,0,0,0
2,1,1,1,17,0,0,0,0
2,1,1,1,17,0,0,0,0
2,1,1,1,17,0,0,0,0
2,1,1,1,17,0,0,0,0
19,10,9,2,75,0,0,0,0
65,52,13,9,5,0,0,0,0
12,6,6,1,1,0,0,0,0
2,1,1,1,75,0,0,0,0
11,7,4,3,17,0,0,0,0
45,9,36,1,103,1,0,0,0
30,29,1,1,94,1,0,0,0
6,3,3,2,110,0,0,0,0
24,16,8,2,110,0,0,0,0
4,2,2,2,90,0,0,0,0
5,3,2,2,104,0,0,0,0
13,9,4,2,0,0,0,0,0
9,4,5,3,75,0,0,0,0
2,0,2,1,95,0,0,0,0
100,72,28,4,0,0,1,0,0
2,0,2,1,95,0,0,0,0
2,0,2,1,95,0,0,0,0
10,9,1,2,12,0,0,0,0
6,6,0,1,94,1,0,0,0
16,15,1,1,94,1,0,0,0
8,4,4,2,75,0,0,0,0
25,20,5,4,17,0,0,0,0
7,2,5,3,0,0,0,0,0
7,4,3,2,75,0,0,0,0
5,5,0,1,0,0,0,0,0
48,42,6,3,0,0,1,0,0
0,0,0,1,35,0,0,0,0
0,0,0,1,35,0,0,0,0
6,6,0,3,3,0,0,0,0
2,2,0,3,3,0,0,0,0
0,0,0,1,35,0,0,0,0
26,24,2,1,104,0,0,0,0
2,1,1,1,104,0,0,0,0
3,2,1,1,111,0,0,0,0
5,2,3,1,104,0,0,0,0
43,27,16,2,104,0,0,0,0
24,16,8,1,104,0,0,0,0
10,7,3,1,104,0,0,0,0
34,23,11,1,104,0,0,0,0
5,3,2,1,111,0,0,0,0
2,1,1,1,111,0,0,0,0
27,20,7,1,104,0,0,0,0
2,1,1,1,104,0,0,0,0
2,1,1,1,104,0,0,0,0
2,1,1,1,104,0,0,0,0
2,1,1,1,104,0,0,0,0
44,36,8,1,104,0,0,0,0
184,92,92,1,104,0,0,0,0
4,2,2,1,104,0,0,0,0
44,36,8,1,104,0,0,0,0
28,14,14,1,104,0,0,0,0
4,2,2,1,104,0,0,0,0
3,2,1,1,104,0,0,0,0
2,2,0,1,104,0,0,0,0
74,45,29,1,104,0,0,0,0
4,1,3,1,104,0,0,0,0
2,1,1,1,104,0,0,0,0
3,2,1,1,104,0,0,0,0
76,45,31,3,4,1,0,0,0
43,39,4,2,4,1,0,0,0
18,17,1,1,104,0,0,0,0
6,3,3,1,104,0,0,0,0
43,41,2,1,104,0,0,0,0
2,1,1,1,104,0,0,0,0
4,2,2,1,104,0,0,0,0
27,16,11,1,104,0,0,0,0
3,2,1,1,104,0,0,0,0
70,44,26,1,104,0,0,0,0
4,2,2,1,104,0,0,0,0
11,8,3,1,104,0,0,0,0
9,0,9,1,104,0,0,0,0
6,3,3,1,104,0,0,0,0
4,2,2,1,104,0,0,0,0
0,0,0,1,104,0,0,0,0
0,0,0,1,104,0,0,0,0
0,0,0,1,104,0,0,0,0
0,0,0,1,104,0,0,0,0
14,11,3,1,104,0,0,0,0
215,206,9,1,104,0,0,0,0
648,635,13,1,104,0,0,0,0
8,7,1,1,104,0,0,0,0
35,32,3,1,104,0,0,0,0
6,3,3,1,104,0,0,0,0
15,7,8,1,104,0,0,0,0
97,95,2,1,104,0,0,0,0
4,3,1,1,104,0,0,0,0
0,0,0,1,104,0,0,0,0
11,11,0,1,104,0,0,0,0
6,1,5,1,104,0,0,0,0
5,4,1,1,104,0,0,0,0
15,10,5,1,104,0,0,0,0
7,6,1,1,104,0,0,0,0
334,329,5,1,104,0,0,0,0
878,767,111,1,104,0,0,0,0
173,152,21,1,104,0,0,0,0
194,131,63,1,104,0,0,0,0
52,51,1,1,104,0,0,0,0
81,80,1,1,104,0,0,0,0
52,50,2,1,104,0,0,0,0
47,32,15,1,104,0,0,0,0
7,6,1,1,104,0,0,0,0
6,4,2,1,104,0,0,0,0
237,226,11,1,104,0,0,0,0
38,25,13,1,104,0,0,0,0
10,6,4,1,104,0,0,0,0
4,2,2,1,104,0,0,0,0
8,7,1,1,104,0,0,0,0
367,296,71,1,104,0,0,0,0
54,53,1,1,104,0,0,0,0
200,185,15,1,104,0,0,0,0
398,331,67,1,104,0,0,0,0
270,167,103,1,104,0,0,0,0
12,10,2,1,104,0,0,0,0
282,277,5,1,104,0,0,0,0
6,5,1,1,104,0,0,0,0
8,5,3,1,104,0,0,0,0
330,253,77,1,104,0,0,0,0
334,324,10,1,104,0,0,0,0
31,28,3,1,104,0,0,0,0
13,11,2,1,104,0,0,0,0
84,69,15,1,104,0,0,0,0
63,47,16,1,104,0,0,0,0
100,98,2,1,104,0,0,0,0
26,21,5,1,104,0,0,0,0
33,29,4,1,104,0,0,0,0
6,3,3,1,104,0,0,0,0
131,117,14,1,104,0,0,0,0
10,1,9,1,104,0,0,0,0
94,64,30,1,104,0,0,0,0
2,1,1,1,104,0,0,0,0
2,1,1,1,104,0,0,0,0
12,9,3,1,104,0,0,0,0
30,28,2,1,104,0,0,0,0
7,4,3,1,104,0,0,0,0
6,3,3,1,104,0,0,0,0
6,3,3,1,104,0,0,0,0
28,19,9,1,104,0,0,0,0
11,2,9,1,104,0,0,0,0
50,38,12,1,104,0,0,0,0
21,12,9,1,104,0,0,0,0
8,4,4,1,104,0,0,0,0
14,9,5,1,104,0,0,0,0
57,55,2,1,104,0,0,0,0
23,17,6,1,104,0,0,0,0
92,45,47,1,104,0,0,0,0
90,64,26,1,104,0,0,0,0
23,17,6,1,104,0,0,0,0
37,34,3,1,104,0,0,0,0
2,1,1,1,104,0,0,0,0
44,29,15,1,104,0,0,0,0
4,2,2,1,104,0,0,0,0
10,5,5,1,104,0,0,0,0
21,18,3,1,104,0,0,0,0
19,18,1,1,104,0,0,0,0
4,2,2,1,104,0,0,0,0
11,7,4,1,104,0,0,0,0
81,55,26,1,104,0,0,0,0
278,235,43,1,104,0,0,0,0
4,2,2,1,104,0,0,0,0
0,0,0,1,104,0,0,0,0
0,0,0,1,104,0,0,0,0
0,0,0,1,104,0,0,0,0
0,0,0,1,104,0,0,0,0
0,0,0,1,104,0,0,0,0
0,0,0,1,104,0,0,0,0
0,0,0,1,104,0,0,0,0
0,0,0,1,104,0,0,0,0
0,0,0,1,104,0,0,0,0
0,0,0,1,104,0,0,0,0
0,0,0,1,104,0,0,0,0
0,0,0,1,104,0,0,0,0
0,0,0,1,104,0,0,0,0
0,0,0,1,104,0,0,0,0
0,0,0,1,104,0,0,0,0
0,0,0,1,104,0,0,0,0
0,0,0,1,104,0,0,0,0
0,0,0,1,104,0,0,0,0
0,0,0,1,104,0,0,0,0
0,0,0,1,104,0,0,0,0
28,7,21,1,35,0,0,0,0
48,26,22,13,6,4,0,0,0
4,4,0,2,6,0,0,0,0
28,7,21,1,35,0,0,0,0
16,8,8,6,6,1,0,0,0
2,1,1,1,115,0,0,0,0
6,6,0,1,14,0,0,0,0
17,8,9,4,27,0,0,0,0
13,5,8,3,27,0,0,0,0
1,1,0,1,27,0,0,0,0
8,4,4,3,27,0,0,0,0
91,71,20,4,27,1,0,0,0
13,10,3,3,75,2,0,0,0
2,1,1,1,75,0,0,0,0
11,8,3,3,75,1,0,0,0
6,6,0,1,75,0,0,0,0
2,2,0,1,75,0,0,0,0
2,1,1,1,90,0,0,0,0
68,66,2,1,90,0,0,0,0
8,4,4,1,90,0,0,0,0
8,4,4,2,35,0,0,0,0
2,1,1,1,35,0,0,0,0
0,0,0,1,55,0,0,0,0
112,54,58,3,53,1,0,0,0
14,13,1,2,53,0,0,0,0
0,0,0,1,55,0,0,0,0
0,0,0,1,55,0,0,0,0
0,0,0,1,55,0,0,0,0
0,0,0,1,55,0,0,0,0
0,0,0,1,55,0,0,0,0
6,3,3,3,27,1,0,0,0
0,0,0,1,27,0,0,0,0
0,0,0,1,27,0,0,0,0
0,0,0,1,27,0,0,0,0
1,0,1,2,27,1,0,0,0
0,0,0,1,28,1,0,0,0
0,0,0,1,27,0,0,0,0
0,0,0,1,27,0,0,0,0
2,1,1,2,27,0,0,0,0
0,0,0,1,27,0,0,0,0
0,0,0,1,27,0,0,0,0
0,0,0,1,68,1,0,0,0
65,32,33,7,14,4,0,0,0
6,5,1,2,17,1,0,0,0
27,23,4,4,17,2,0,0,0
26,8,18,5,12,2,0,0,0
13,9,4,2,17,1,0,0,0
48,21,27,5,14,2,0,0,0
36,33,3,2,14,1,0,0,0
5,2,3,1,17,1,0,0,0
51,51,0,2,17,1,0,0,0
36,14,22,3,14,2,0,0,0
26,13,13,4,14,3,0,0,0
41,18,23,5,14,2,0,0,0
113,96,17,3,14,2,0,0,0
102,29,73,2,17,2,0,0,0
10,2,8,2,17,2,0,0,0
77,52,25,3,40,2,0,0,0
2,1,1,1,40,1,0,0,0
224,211,13,3,33,0,0,0,0
1,1,0,1,17,0,0,0,0
430,174,256,8,3,3,0,0,0
246,210,36,4,3,1,0,0,0
2,1,1,1,17,0,0,0,0
2,1,1,1,17,0,0,0,0
5,4,1,2,4,0,0,0,0
2,1,1,2,17,0,0,0,0
12,10,2,3,17,1,0,0,0
292,262,30,8,39,1,0,0,0
95,55,40,5,16,2,0,0,0
6,3,3,1,105,1,0,0,0
2,1,1,1,4,0,0,0,0
4,2,2,1,75,0,0,0,0
149,88,61,1,17,0,0,0,0
648,433,215,14,15,3,0,0,0
2,1,1,1,17,0,0,0,0
3,3,0,1,17,0,0,0,0
42,41,1,2,43,0,0,0,0
224,169,55,7,1,2,0,0,0
2,1,1,1,105,1,0,0,0
2,1,1,1,105,1,0,0,0
6,3,3,2,17,1,0,0,0
2,1,1,1,17,0,0,0,0
2,1,1,1,17,0,0,0,0
2,1,1,1,17,0,0,0,0
2,1,1,1,17,0,0,0,0
2,1,1,1,17,0,0,0,0
5,4,1,1,17,0,0,0,0
4,2,2,1,17,0,0,0,0
2,1,1,1,17,0,0,0,0
38,23,15,5,17,2,0,0,0
2,2,0,1,75,0,0,0,0
5,5,0,2,36,0,0,0,0
21,17,4,4,36,3,0,0,0
654,500,154,9,36,0,0,0,0
22,15,7,5,17,1,0,0,0
36,34,2,3,36,0,0,0,0
1,0,1,1,76,0,0,0,0
2,1,1,2,76,0,0,0,0
2,1,1,2,76,0,0,0,0
2,1,1,2,76,0,0,0,0
0,0,0,1,76,0,0,0,0
0,0,0,1,76,0,0,0,0
2,1,1,1,90,0,0,0,0
25,22,3,4,75,0,0,0,0
2,1,1,2,90,0,0,0,0
25,6,19,2,77,1,0,0,0
3,2,1,1,75,0,0,0,0
27,18,9,3,76,0,0,0,0
28,24,4,3,77,2,0,0,0
2,1,1,2,90,0,0,0,0
13,6,7,4,77,2,0,0,0
128,99,29,7,77,5,0,0,0
66,54,12,2,78,0,0,0,0
252,238,14,8,75,2,0,0,0
67,61,6,4,38,0,0,0,0
384,215,169,8,17,1,0,0,0
16,9,7,2,75,0,0,0,0
2,1,1,1,41,0,0,0,0
302,246,56,5,39,4,0,0,0
2,1,1,1,90,0,0,0,0
98,80,18,6,75,2,0,0,0
58,32,26,10,75,4,0,0,0
11,7,4,2,75,0,0,0,0
14,9,5,3,17,0,0,0,0
9,6,3,3,17,1,0,0,0
9,6,3,2,17,0,0,0,0
9,6,3,2,17,0,0,0,0
10,5,5,2,53,2,0,0,0
22,13,9,2,109,0,0,0,0
2,1,1,2,105,0,0,0,0
66,28,38,5,55,0,0,0,0
21,18,3,5,55,0,0,0,0
2,1,1,1,108,0,0,0,0
0,0,0,1,105,0,0,0,0
16,15,1,4,54,0,0,0,0
15,15,0,1,55,0,0,0,0
9,8,1,1,96,1,0,0,0
145,145,0,1,55,0,0,0,0
8,4,4,2,71,1,0,0,0
91,50,41,3,21,1,0,0,0
4,2,2,1,73,1,0,0,0
3,2,1,1,75,0,0,0,0
24,17,7,2,42,2,0,0,0
7,5,2,1,43,0,0,0,0
202,165,37,3,23,0,0,0,0
293,185,108,3,23,0,0,0,0
2,0,2,2,51,0,0,0,0
2,1,1,2,29,1,0,0,0
4,4,0,1,91,0,0,0,0
2,1,1,1,35,0,0,0,0
6,3,3,1,90,0,0,0,0
8,5,3,1,91,1,0,0,0
0,0,0,1,90,0,0,0,0
4,2,2,1,79,0,0,0,0
4,2,2,1,91,1,0,0,0
2,1,1,1,65,0,0,0,0
2,1,1,1,42,0,0,0,0
2,1,1,1,42,0,0,0,0
15,15,0,1,102,0,0,0,0
19,17,2,4,75,2,0,0,0
4,2,2,1,90,0,0,0,0
5,3,2,2,17,0,0,0,0
7,4,3,2,90,1,0,0,0
8,7,1,1,4,0,0,0,0
0,0,0,1,90,0,0,0,0
0,0,0,1,35,0,0,0,0
0,0,0,1,55,0,0,0,0
8,3,5,2,53,1,0,0,0
2,1,1,2,53,1,0,0,0
0,0,0,1,55,0,0,0,0
4,2,2,1,90,0,0,0,0
48,19,29,4,45,1,0,0,0
7,4,3,1,46,0,0,0,0
6,4,2,2,71,1,0,0,0
11,6,5,1,47,0,0,0,0
1,1,0,1,90,0,0,0,0
1,1,0,1,90,0,0,0,0
1,1,0,1,90,0,0,0,0
26,24,2,3,46,1,0,0,0
38,37,1,2,46,0,0,0,0
10,3,7,3,42,2,0,0,0
38,14,24,4,42,1,0,0,0
63,40,23,2,45,0,0,0,0
0,0,0,1,46,0,0,0,0
5,3,2,1,90,0,0,0,0
4,3,1,1,90,0,0,0,0
12,7,5,2,71,1,0,0,0
35,16,19,2,71,1,0,0,0
44,44,0,1,90,0,0,0,0
6,3,3,1,90,0,0,0,0
2,1,1,1,90,0,0,0,0
1,1,0,1,17,0,0,0,0
2,2,0,2,77,2,0,0,0
77,75,2,2,74,1,0,0,0
1,1,0,1,90,0,0,0,0
11,6,5,1,90,0,0,0,0
15,8,7,1,90,0,0,0,0
7,4,3,1,90,0,0,0,0
23,22,1,2,36,0,0,0,0
12,4,8,2,71,1,0,0,0
4,2,2,3,4,0,0,0,0
0,0,0,1,41,0,0,0,0
112,20,92,2,41,0,0,0,0
1,1,0,2,41,0,0,0,0
4,2,2,1,90,0,0,0,0
1,1,0,1,90,0,0,0,0
3,2,1,1,90,0,0,0,0
26,8,18,2,71,1,0,0,0
8,5,3,1,90,0,0,0,0
12,9,3,2,68,0,0,0,0
180,139,41,14,29,4,0,0,0
76,75,1,1,90,0,0,0,0
1,1,0,1,90,0,0,0,0
11,7,4,2,25,0,0,0,0
55,41,14,3,40,0,0,0,0
12,7,5,2,40,1,0,0,0
3,2,1,1,90,0,0,0,0
3,2,1,1,90,0,0,0,0
5,5,0,2,90,0,0,0,0
5,3,2,1,90,0,0,0,0
11,6,5,1,90,0,0,0,0
13,8,5,2,75,1,0,0,0
3,2,1,1,90,0,0,0,0
36,27,9,2,29,0,0,0,0
1,1,0,1,90,0,0,0,0
15,8,7,2,75,1,0,0,0
10,8,2,2,36,0,0,0,0
1,1,0,1,90,0,0,0,0
27,16,11,1,29,0,0,0,0
1,0,1,1,71,1,0,0,0
3,1,2,1,71,1,0,0,0
16,5,11,2,48,2,0,0,0
10,10,0,2,95,2,0,0,0
42,40,2,2,38,0,0,0,0
27,27,0,1,103,1,0,0,0
98,70,28,3,38,1,0,0,0
2,1,1,1,41,0,0,0,0
0,0,0,1,74,0,0,0,0
6,3,3,1,32,0,0,0,0
1,1,0,1,90,0,0,0,0
81,65,16,6,22,2,0,0,0
375,316,59,10,33,3,0,0,0
3,2,1,2,47,0,0,0,0
6,4,2,1,41,1,0,0,0
1,1,0,1,90,0,0,0,0
24,16,8,1,41,1,0,0,0
2,2,0,1,22,0,0,0,0
2,2,0,1,90,0,0,0,0
7,4,3,2,32,0,0,0,0
13,9,4,1,78,0,0,0,0
33,21,12,2,46,1,0,0,0
41,27,14,5,22,1,0,0,0
1,1,0,1,90,0,0,0,0
95,27,68,3,25,1,0,0,0
53,40,13,6,22,2,0,0,0
1,1,0,1,24,0,0,0,0
143,104,39,6,22,1,0,0,0
32,32,0,3,35,1,0,0,0
1,1,0,1,90,0,0,0,0
112,61,51,5,57,1,0,0,0
2,0,2,1,71,1,0,0,0
3,1,2,2,71,1,0,0,0
1,1,0,1,90,0,0,0,0
4,3,1,2,67,0,0,0,0
251,250,1,4,42,0,0,0,0
7,4,3,3,46,0,0,0,0
2,1,1,2,20,0,0,0,0
75,51,24,3,20,1,0,0,0
2,1,1,1,39,0,0,0,0
67,47,20,2,17,0,0,0,0
3,2,1,1,90,0,0,0,0
1,1,0,1,90,0,0,0,0
1,1,0,1,17,0,0,0,0
10,7,3,3,14,1,0,0,0
0,0,0,1,94,0,0,0,0
0,0,0,1,94,0,0,0,0
7,2,5,2,71,1,0,0,0
1,1,0,1,97,0,0,0,0
13,5,8,1,78,1,0,0,0
1,1,0,1,83,0,0,0,0
38,20,18,3,1,0,0,0,0
2,1,1,1,4,0,0,0,0
2,1,1,1,95,0,0,0,0
200,118,82,3,17,0,0,0,0
17,17,0,1,83,0,0,0,0
6,5,1,2,90,1,0,0,0
7,5,2,1,75,0,0,0,0
0,0,0,1,83,0,0,0,0
0,0,0,1,83,0,0,0,0
2,2,0,1,75,0,0,0,0
15,8,7,2,46,1,0,0,0
23,12,11,2,46,0,0,0,0
97,75,22,1,73,1,0,0,0
11,9,2,1,73,1,0,0,0
1037,675,362,5,75,0,0,0,0
72,14,58,2,83,0,0,0,0
0,0,0,1,84,0,0,0,0
60,30,30,2,84,1,0,0,0
20,14,6,4,17,1,0,0,0
24,12,12,2,35,0,0,0,0
175,173,2,3,75,0,0,0,0
8,4,4,1,90,0,0,0,0
4,2,2,1,75,0,0,0,0
51,51,0,1,75,0,0,0,0
2,1,1,1,90,0,0,0,0
0,0,0,1,77,1,0,0,0
28,11,17,2,71,1,0,0,0
139,138,1,5,37,0,0,0,0
163,59,104,6,38,2,0,0,0
5,3,2,1,90,0,0,0,0
32,11,21,3,32,1,0,0,0
2,1,1,1,90,0,0,0,0
3,2,1,1,90,0,0,0,0
11,6,5,1,90,0,0,0,0
7,4,3,1,90,0,0,0,0
21,11,10,4,24,1,0,0,0
1,1,0,1,90,0,0,0,0
733,13,720,5,75,1,0,0,0
2487,1257,1230,3,38,1,0,0,0
527,394,133,17,17,2,0,0,0
33,31,2,10,36,1,0,0,0
4,2,2,3,40,0,0,0,0
1,1,0,1,90,0,0,0,0
2,1,1,2,42,1,0,0,0
197,66,131,7,1,2,0,0,0
4,3,1,1,45,1,0,0,0
91,42,49,4,42,3,0,0,0
4,2,2,2,1,0,0,0,0
2,1,1,1,13,0,0,0,0
57,27,30,4,13,1,0,0,0
2,1,1,1,4,0,0,0,0
23,21,2,3,75,0,0,0,0
0,0,0,1,5,0,0,0,0
42,21,21,2,35,0,0,0,0
209,170,39,5,12,2,0,0,0
1,1,0,1,75,0,0,0,0
7,5,2,4,75,1,0,0,0
6,3,3,1,75,0,0,0,0
26,23,3,5,35,2,0,0,0
2,1,1,1,29,0,0,0,0
8,4,4,1,29,0,0,0,0
2,1,1,1,90,0,0,0,0
4,4,0,1,75,0,0,0,0
74,42,32,5,77,1,0,0,0
15,8,7,4,77,1,0,0,0
519,294,225,11,77,2,0,0,0
11,8,3,1,75,0,0,0,0
3,2,1,1,75,0,0,0,0
4,2,2,2,34,0,0,0,0
18,17,1,2,29,0,0,0,0
34,27,7,7,3,1,0,0,0
377,251,126,18,28,4,0,0,0
138,69,69,1,90,0,0,0,0
21,11,10,2,90,0,0,0,0
159,133,26,8,3,1,0,0,0
106,78,28,1,95,0,0,0,0
38,36,2,3,39,1,0,0,0
1,1,0,1,36,0,0,0,0
3,2,1,1,33,1,0,0,0
16,4,12,2,29,0,0,0,0
512,375,137,28,28,4,0,0,0
180,119,61,4,29,0,0,0,0
34,29,5,5,33,3,0,0,0
10,9,1,2,34,1,0,0,0
22,19,3,3,57,0,0,0,0
40,28,12,3,39,0,0,0,0
2,1,1,1,57,0,0,0,0
2,1,1,1,57,0,0,0,0
96,79,17,4,28,1,0,0,0
20,16,4,2,36,1,0,0,0
15,13,2,2,57,0,0,0,0
57,56,1,2,28,1,0,0,0
36,17,19,2,55,1,0,0,0
19,16,3,4,3,0,0,0,0
21,17,4,6,3,1,0,0,0
875,292,583,6,32,0,0,0,0
8,6,2,4,51,2,0,0,0
0,0,0,1,116,1,0,0,0
0,0,0,1,116,1,0,0,0
5,3,2,4,75,1,0,0,0
72,50,22,1,95,0,0,0,0
31,24,7,9,3,4,0,0,0
364,363,1,3,3,0,0,0,0
80,77,3,3,38,0,0,0,0
150,108,42,3,3,0,0,0,0
0,0,0,1,91,1,0,0,0
28,19,9,6,78,1,0,0,0
12,9,3,5,81,1,0,0,0
42,16,26,2,17,0,0,0,0
8,4,4,2,17,0,0,0,0
8,6,2,4,75,1,0,0,0
7,6,1,2,75,0,0,0,0
5,5,0,2,75,0,0,0,0
6,4,2,1,75,0,0,0,0
2,1,1,1,41,0,0,0,0
4,2,2,1,75,0,0,0,0
26,13,13,3,14,0,0,0,0
2134,1082,1052,1,55,0,0,0,0
9,8,1,3,31,1,0,0,0
103,70,33,3,53,1,0,0,0
6,3,3,2,53,1,0,0,0
0,0,0,1,55,0,0,0,0
0,0,0,1,55,0,0,0,0
54,41,13,1,76,1,0,0,0
39,23,16,2,86,1,0,0,0
1117,691,426,35,36,8,0,0,0
9,8,1,1,55,0,0,0,0
16,15,1,1,86,0,0,0,0
13,11,2,1,77,1,0,0,0
52,13,39,2,90,0,0,0,0
34,17,17,2,75,0,0,0,0
17,15,2,4,47,2,0,0,0
86,85,1,2,90,0,0,0,0
2,2,0,1,90,0,0,0,0
2,1,1,1,75,0,0,0,0
75,69,6,3,17,2,0,0,0
1,0,1,1,101,1,0,0,0
7,1,6,2,75,1,0,0,0
21,11,10,3,75,2,0,0,0
29,15,14,1,75,0,0,0,0
142,88,54,4,75,1,0,0,0
2,2,0,1,109,1,0,0,0
6,3,3,1,75,0,0,0,0
85,48,37,6,45,1,0,0,0
5,3,2,2,71,1,0,0,0
21,11,10,2,75,0,0,0,0
3,2,1,2,75,0,0,0,0
160,119,41,1,104,1,0,0,0
235,147,88,2,75,1,0,0,0
0,0,0,1,43,0,0,0,0
6,5,1,1,67,1,0,0,0
0,0,0,1,5,0,0,0,0
2,2,0,1,41,0,0,0,0
1,1,0,1,33,0,0,0,0
0,0,0,1,78,0,0,0,0
1,1,0,1,90,0,0,0,0
18,12,6,4,94,0,0,0,0
8,4,4,1,6,0,0,0,0
0,0,0,1,5,0,0,0,0
0,0,0,1,78,0,0,0,0
0,0,0,1,37,0,0,0,0
6,6,0,2,39,2,0,0,0
6,3,3,3,38,1,0,0,0
4,4,0,2,38,1,0,0,0
0,0,0,1,36,0,0,0,0
0,0,0,1,36,0,0,0,0
2,1,1,2,36,0,0,0,0
0,0,0,1,36,0,0,0,0
5,3,2,2,36,1,0,0,0
0,0,0,1,38,0,0,0,0
0,0,0,1,38,0,0,0,0
0,0,0,1,36,0,0,0,0
32,27,5,7,36,0,0,0,0
4,2,2,2,75,0,0,0,0
0,0,0,1,36,0,0,0,0
0,0,0,2,36,0,0,0,0
0,0,0,1,36,0,0,0,0
2,1,1,1,75,0,0,0,0
2,1,1,2,36,0,0,0,0
0,0,0,1,36,0,0,0,0
0,0,0,1,36,0,0,0,0
1,1,0,2,36,0,0,0,0
2,1,1,2,36,0,0,0,0
4,2,2,2,38,0,0,0,0
2,1,1,1,35,0,0,0,0
2,1,1,2,36,0,0,0,0
55,1,54,2,36,0,0,0,0
2,1,1,2,36,0,0,0,0
2,1,1,2,38,0,0,0,0
4,2,2,3,51,0,0,0,0
2,1,1,2,40,0,0,0,0
2,1,1,2,36,0,0,0,0
2,1,1,2,40,0,0,0,0
0,0,0,1,20,0,0,0,0
0,0,0,1,38,0,0,0,0
2,1,1,2,38,1,0,0,0
63,55,8,3,38,1,0,0,0
156,126,30,6,38,2,0,0,0
7,4,3,6,52,0,0,0,0
7,6,1,3,38,0,0,0,0
15,11,4,3,39,0,0,0,0
21,16,5,6,38,1,0,0,0
40,33,7,3,40,1,0,0,0
9,9,0,3,40,1,0,0,0
1,1,0,2,38,0,0,0,0
1825,1123,702,43,12,11,1,0,0
5,5,0,2,40,0,0,0,0
107,71,36,4,40,1,0,0,0
20,13,7,3,33,0,0,0,0
37,27,10,4,32,1,0,0,0
21,10,11,5,40,1,0,0,0
42,33,9,10,32,2,0,0,0
35,26,9,6,39,3,0,0,0
27,17,10,7,40,2,0,0,0
4,2,2,2,40,1,0,0,0
87,58,29,8,32,4,0,0,0
27,12,15,3,40,2,0,0,0
0,0,0,1,51,0,0,0,0
2,1,1,1,95,0,0,0,0
11,7,4,3,51,1,0,0,0
81,46,35,4,76,1,0,0,0
11,8,3,3,39,0,0,0,0
61,36,25,26,5,5,0,0,0
43,28,15,7,33,2,0,0,0
49,28,21,12,3,1,0,0,0
2,1,1,1,95,0,0,0,0
2,1,1,1,95,0,0,0,0
2,1,1,1,95,0,0,0,0
2,1,1,1,95,0,0,0,0
0,0,0,1,97,0,0,0,0
2,1,1,3,50,0,0,0,0
0,0,0,1,97,0,0,0,0
9,4,5,2,32,0,0,0,0
0,0,0,1,12,1,0,0,0
58,24,34,6,32,3,0,0,0
9,4,5,2,32,0,0,0,0
22,10,12,4,51,3,0,0,0
0,0,0,1,67,1,0,0,0
12,7,5,4,39,2,0,0,0
36,30,6,3,90,1,0,0,0
232,122,110,3,46,3,0,0,0
8,7,1,2,34,0,0,0,0
6,3,3,1,75,1,0,0,0
6,6,0,1,117,0,0,0,0
5,3,2,1,75,0,0,0,0
1,1,0,1,90,0,0,0,0
16,13,3,2,29,0,0,0,0
8,6,2,2,31,1,0,0,0
165,144,21,7,33,2,0,0,0
4,2,2,2,46,1,0,0,0
28,23,5,5,22,1,0,0,0
61,51,10,3,22,1,0,0,0
49,42,7,5,22,2,0,0,0
6,3,3,2,40,1,0,0,0
6,5,1,2,29,0,0,0,0
7,4,3,2,36,1,0,0,0
9,8,1,2,22,0,0,0,0
12,9,3,5,17,2,0,0,0
5,4,1,1,90,0,0,0,0
4,2,2,1,17,0,0,0,0
7,2,5,2,17,0,0,0,0
4,2,2,1,17,0,0,0,0
52,41,11,7,11,2,0,0,0
0,0,0,1,45,0,0,0,0
6,4,2,2,12,1,0,0,0
6,6,0,1,45,0,0,0,0
13,8,5,3,71,1,0,0,0
3,2,1,1,90,0,0,0,0
1,1,0,1,90,0,0,0,0
8,5,3,4,65,1,0,0,0
295,180,115,6,28,2,0,0,0
1,1,0,1,90,0,0,0,0
1,1,0,1,90,0,0,0,0
3,1,2,1,65,0,0,0,0
3,2,1,2,65,0,0,0,0
1,1,0,1,90,0,0,0,0
2,2,0,1,90,0,0,0,0
2309,1626,683,9,17,3,0,0,0
818,487,331,19,33,6,0,0,0
111,70,41,5,17,2,0,0,0
6,4,2,2,71,2,0,0,0
10,5,5,3,65,1,0,0,0
2,1,1,1,75,0,0,0,0
2,1,1,1,75,0,0,0,0
4,1,3,1,75,0,0,0,0
2,1,1,1,65,0,0,0,0
170,80,90,10,17,4,1,0,0
15,7,8,2,71,2,0,0,0
6,3,3,1,78,1,0,0,0
8,4,4,1,78,1,0,0,0
2,1,1,1,78,1,0,0,0
4,2,2,1,78,1,0,0,0
20,11,9,3,73,3,0,0,0
6,3,3,1,116,1,0,0,0
4,2,2,2,65,0,0,0,0
7,2,5,2,27,0,0,0,0
61,31,30,6,81,1,1,0,0
30,19,11,3,17,1,0,0,0
28,19,9,2,17,1,0,0,0
13,9,4,3,17,1,0,0,0
6,2,4,2,29,0,0,0,0
2,1,1,1,71,1,0,0,0
456,376,80,11,17,3,0,0,0
9,7,2,3,26,1,0,0,0
5,2,3,2,26,1,0,0,0
10,4,6,2,26,1,0,0,0
4,2,2,2,26,1,0,0,0
2,1,1,1,71,1,0,0,0
18,9,9,1,71,1,0,0,0
2,1,1,1,65,0,0,0,0
12,6,6,2,77,1,0,0,0
4,2,2,2,65,0,0,0,0
3,2,1,2,90,1,0,0,0
1,1,0,1,90,0,0,0,0
4,2,2,1,71,1,0,0,0
1,1,0,1,90,0,0,0,0
1,1,0,1,90,0,0,0,0
1,1,0,1,90,0,0,0,0
10,5,5,3,75,2,0,0,0
3,2,1,3,65,1,0,0,0
1,1,0,1,90,0,0,0,0
1,1,0,1,90,0,0,0,0
1,1,0,1,90,0,0,0,0
13,6,7,2,75,2,0,0,0
11,5,6,2,75,0,0,0,0
122,77,45,5,75,3,0,0,0
902,744,158,14,76,1,0,0,0
1,1,0,1,90,0,0,0,0
8,6,2,3,42,0,0,0,0
18,18,0,2,36,0,0,0,0
8,7,1,2,112,0,0,0,0
2,1,1,1,70,1,0,0,0
3,2,1,2,70,1,0,0,0
13,12,1,2,90,0,0,0,0
1,1,0,1,90,0,0,0,0
105,92,13,3,39,1,0,0,0
0,0,0,1,42,0,0,0,0
1,1,0,1,90,0,0,0,0
1,1,0,1,90,0,0,0,0
7,1,6,1,75,0,0,0,0
1,1,0,1,90,0,0,0,0
1,1,0,1,90,0,0,0,0
10,5,5,3,70,2,0,0,0
20,10,10,2,1,0,0,0,0
2,1,1,1,17,0,0,0,0
29,15,14,3,1,1,0,0,0
1,1,0,1,90,0,0,0,0
2,1,1,1,95,0,0,0,0
8,4,4,2,17,1,0,0,0
4,2,2,2,17,1,0,0,0
1,1,0,1,90,0,0,0,0
13,7,6,4,17,2,0,0,0
46,44,2,3,17,0,0,0,0
80,67,13,7,56,5,0,0,0
11,6,5,3,17,1,0,0,0
87,62,25,1,109,1,0,0,0
2,1,1,1,17,0,0,0,0
11,6,5,3,17,1,0,0,0
1,1,0,1,90,0,0,0,0
399,375,24,8,17,4,0,0,0
6,5,1,1,71,1,0,0,0
4,2,2,3,65,0,0,0,0
1,0,1,1,65,0,0,0,0
36,24,12,4,17,1,0,0,0
17,13,4,2,22,0,0,0,0
377,338,39,12,33,3,0,0,0
47,41,6,2,31,0,0,0,0
372,270,102,9,27,5,0,0,0
2,1,1,2,46,0,0,0,0
86,54,32,3,73,0,0,0,0
120,112,8,5,32,1,0,0,0
32,16,16,3,31,0,0,0,0
4,4,0,1,34,1,0,0,0
71,65,6,9,34,2,0,0,0
57,10,47,4,32,0,0,0,0
54,41,13,8,17,1,0,0,0
0,0,0,1,65,0,0,0,0
45,34,11,7,52,2,0,0,0
7,4,3,3,65,0,0,0,0
9,3,6,3,65,1,0,0,0
28,26,2,5,65,2,0,0,0
2,1,1,1,65,0,0,0,0
4,2,2,1,71,1,0,0,0
3,2,1,2,71,1,0,0,0
39,8,31,4,65,0,1,0,0
317,46,271,5,83,1,1,0,0
11,5,6,4,65,1,0,0,0
28,18,10,4,56,3,0,0,0
2,1,1,1,65,0,0,0,0
25,16,9,5,17,1,0,0,0
2,1,1,2,76,1,0,0,0
90,79,11,4,76,2,0,0,0
23,12,11,2,76,1,0,0,0
7,4,3,2,76,1,0,0,0
17,9,8,2,76,1,0,0,0
19,10,9,3,76,1,0,0,0
16,11,5,2,17,1,0,0,0
37,19,18,5,4,2,0,0,0
38,25,13,2,38,0,0,0,0
0,0,0,1,39,0,0,0,0
0,0,0,1,38,1,0,0,0
24,17,7,2,38,0,0,0,0
23,6,17,1,38,0,0,0,0
179,155,24,4,38,0,0,0,0
874,260,614,4,75,0,0,0,0
42,24,18,3,75,0,0,0,0
67,0,67,1,77,1,0,0,0
3,2,1,1,73,1,0,0,0
9,5,4,1,73,1,0,0,0
3,2,1,1,76,1,0,0,0
11,7,4,1,76,1,0,0,0
47,36,11,1,117,0,0,0,0
35,0,35,3,3,2,0,0,0
70,70,0,1,94,0,0,0,0
19,3,16,1,77,1,0,0,0
96,69,27,5,56,4,0,0,0
3,0,3,1,77,1,0,0,0
17,13,4,3,3,0,0,0,0
2,0,2,1,3,1,0,0,0
48,38,10,1,117,0,0,0,0
50,39,11,1,117,0,0,0,0
10,4,6,2,81,1,0,0,0
49,38,11,1,117,0,0,0,0
14,6,8,3,81,1,0,0,0
0,0,0,2,55,0,0,0,0
0,0,0,2,55,0,0,0,0
0,0,0,2,55,0,0,0,0
0,0,0,2,55,0,0,0,0
50,49,1,3,97,1,0,0,0
2,1,1,1,45,0,0,0,0
25,23,2,1,97,1,0,0,0
64,53,11,2,98,0,0,0,0
9,5,4,2,75,1,0,0,0
1,1,0,1,97,1,0,0,0
2,1,1,1,95,0,0,0,0
2,1,1,1,95,0,0,0,0
2,1,1,1,95,0,0,0,0
2,1,1,1,95,0,0,0,0
2,1,1,1,95,0,0,0,0
2,1,1,1,95,0,0,0,0
4,2,2,2,41,0,0,0,0
24,4,20,2,5,0,0,0,0
15,1,14,1,76,0,0,0,0
54,28,26,4,41,2,0,0,0
2,2,0,1,76,0,0,0,0
15,1,14,1,76,0,0,0,0
15,1,14,1,76,0,0,0,0
17,2,15,3,76,1,0,0,0
43,27,16,3,5,0,0,0,0
24,6,18,5,5,2,0,0,0
0,0,0,1,19,1,0,0,0
0,0,0,1,36,1,0,0,0
0,0,0,1,40,0,0,0,0
0,0,0,1,36,0,0,0,0
0,0,0,1,36,0,0,0,0
0,0,0,1,36,0,0,0,0
36,27,9,3,12,1,0,0,0
0,0,0,1,40,0,0,0,0
3,0,3,1,119,0,0,0,0
0,0,0,1,40,0,0,0,0
0,0,0,1,40,0,0,0,0
3,2,1,1,82,1,0,0,431
