CODECHURN,LOCADDED,LOCDELETED,REVISIONS,AGE,BUGFIXES,REFACTORINGS,ERROR_DENSITY,LOC
2,1,1,2,9,2,0,0,57
137,76,61,3,9,2,1,0,170
8,1,7,2,10,1,0,0,105
45,23,22,2,9,2,0,0,101
0,0,0,1,55,1,0,0,48
0,0,0,1,55,1,0,0,30
3,1,2,2,9,2,1,0,30
0,0,0,1,55,1,0,0,49
0,0,0,1,55,1,0,0,48
40,18,22,4,9,3,1,0,71
0,0,0,1,55,1,0,0,65
0,0,0,1,55,1,0,0,48
0,0,0,1,55,1,0,0,35
4,3,1,2,9,2,0,0,57
0,0,0,1,55,1,0,0,49
48,45,3,3,9,2,0,0,175
0,0,0,1,55,1,0,0,38
0,0,0,1,55,1,0,0,126
138,71,67,4,9,4,1,0,411
0,0,0,1,55,1,0,0,31
0,0,0,1,55,1,0,0.0117647058823529,170
0,0,0,1,55,1,0,0,45
0,0,0,1,55,1,0,0.0113636363636364,88
0,0,0,1,55,1,0,0,42
207,112,95,5,9,5,0,0.00738007380073801,542
39,32,7,2,9,2,0,0,140
30,21,9,5,9,4,0,0.0158730158730159,126
119,72,47,5,9,5,0,0.00505050505050505,396
11,7,4,2,9,2,0,0,46
40,21,19,2,10,1,0,0,72
5,3,2,3,9,2,0,0.00657894736842105,152
0,0,0,1,55,1,0,0,30
0,0,0,1,55,1,0,0,31
0,0,0,1,55,1,0,0,71
0,0,0,1,55,1,0,0,77
4,3,1,2,9,2,0,0,52
0,0,0,1,55,1,0,0,32
0,0,0,1,55,1,0,0,45
0,0,0,1,55,1,0,0.00793650793650794,126
0,0,0,1,55,1,0,0,135
0,0,0,1,55,1,0,0,125
0,0,0,1,55,1,0,0,243
0,0,0,1,55,1,0,0,124
2,0,2,2,9,2,0,0,136
80,40,40,2,9,2,1,0,638
14,7,7,3,9,3,1,0,296
0,0,0,1,55,1,0,0,137
0,0,0,1,55,1,0,0.0224719101123595,89
8,4,4,2,9,2,1,0,208
36,26,10,3,9,3,0,0.00323624595469256,309
0,0,0,1,55,1,0,0,46
185,123,62,3,9,3,0,0,248
48,19,29,6,9,5,1,0.00240963855421687,415
0,0,0,1,55,1,0,0,37
0,0,0,1,55,1,0,0,204
0,0,0,1,55,1,0,0,40
0,0,0,1,55,1,0,0.00523560209424084,191
0,0,0,1,39,1,0,0,0
0,0,0,1,39,1,0,0,0
0,0,0,1,39,1,0,0,0
4,2,2,2,39,1,0,0,0
0,0,0,1,39,1,0,0,0
0,0,0,1,39,1,0,0,0
20,10,10,2,29,1,0,0,275
14,7,7,2,29,1,0,0,356
6,1,5,1,28,0,0,0,167
6,1,5,1,28,0,0,0,45
12,6,6,2,29,1,0,0,237
20,10,10,2,29,1,0,0,261
15,6,9,3,16,3,0,0,0
15,6,9,3,16,3,0,0,0
23,8,15,3,16,3,0,0,0
10,5,5,3,16,3,0,0,0
7,2,5,3,16,3,0,0,0
14,6,8,3,16,3,0,0,0
6,3,3,3,16,3,0,0,0
3,1,2,3,16,3,0,0,0
11,7,4,3,16,3,0,0,0
10,5,5,3,16,3,0,0,0
4,1,3,3,16,3,0,0,0
0,0,0,2,16,2,0,0,0
0,0,0,2,16,2,0,0,0
1,0,1,3,16,2,0,0,0
0,0,0,2,16,2,0,0,0
0,0,0,2,16,2,0,0,0
0,0,0,2,16,2,0,0,0
4,1,3,3,16,3,0,0,0
3,1,2,3,16,3,0,0,0
0,0,0,2,35,2,0,0,0
0,0,0,2,35,2,0,0,0
17,3,14,3,21,2,0,0,0
0,0,0,2,35,2,0,0,0
0,0,0,2,35,2,0,0,0
14,1,13,4,21,3,0,0,0
43,20,23,3,21,2,0,0,0
55,15,40,3,21,2,0,0,0
0,0,0,2,35,2,0,0,0
0,0,0,2,35,2,0,0,0
0,0,0,2,21,1,0,0,0
0,0,0,2,35,2,0,0,0
0,0,0,2,35,2,0,0,0
0,0,0,2,21,1,0,0,0
0,0,0,2,21,1,0,0,0
0,0,0,2,35,2,0,0,0
0,0,0,2,35,2,0,0,0
0,0,0,2,35,2,0,0,0
0,0,0,2,35,2,0,0,0
0,0,0,2,35,2,0,0,0
4,2,2,3,21,2,0,0,0
19,5,14,3,21,2,0,0,0
5,2,3,3,21,2,0,0,0
98,36,62,3,21,2,0,0,0
115,34,81,3,21,2,0,0,0
0,0,0,2,35,2,0,0,0
0,0,0,2,21,1,0,0,0
33,8,25,4,21,3,0,0,0
25,5,20,3,21,2,0,0,0
0,0,0,2,35,2,0,0,0
0,0,0,2,35,2,0,0,0
0,0,0,2,35,2,0,0,0
0,0,0,2,35,2,0,0,0
0,0,0,2,35,2,0,0,0
0,0,0,2,21,1,0,0,0
0,0,0,2,21,1,0,0,0
2,1,1,3,21,2,0,0,0
0,0,0,2,39,2,0,0,0
0,0,0,2,39,2,0,0,0
0,0,0,2,39,2,0,0,0
0,0,0,2,39,2,0,0,0
0,0,0,2,39,2,0,0,0
0,0,0,2,39,2,0,0,0
0,0,0,1,21,0,0,0.0048780487804878,205
0,0,0,1,21,0,0,0,132
0,0,0,1,21,0,0,0,116
0,0,0,1,21,0,0,0,105
0,0,0,1,21,0,0,0,63
0,0,0,1,21,0,0,0.0111111111111111,90
0,0,0,1,21,0,0,0,102
0,0,0,1,21,0,0,0,77
0,0,0,1,21,0,0,0,332
0,0,0,1,21,0,0,0,245
0,0,0,1,21,0,0,0,35
0,0,0,1,21,0,0,0,88
0,0,0,1,21,0,0,0,47
0,0,0,1,21,0,0,0,128
0,0,0,1,21,0,0,0,90
0,0,0,1,21,0,0,0,71
1,1,0,2,21,1,1,0.0131578947368421,76
61,50,11,3,21,3,1,0,0
0,0,0,1,68,1,0,0.0476190476190476,21
0,0,0,1,68,1,0,0.012987012987013,77
0,0,0,1,21,1,1,0.0185185185185185,54
64,30,34,2,21,1,1,0,0
21,14,7,5,28,3,0,0.0434782608695652,46
4,4,0,1,132,1,0,0.0625,32
12,7,5,4,28,2,0,0.0625,32
0,0,0,1,21,1,1,0.00961538461538462,104
45,37,8,3,21,3,1,0,0
121,41,80,3,21,2,1,0.00900900900900901,111
0,0,0,1,21,1,1,0.00671140939597315,149
0,0,0,1,21,1,1,0,0
0,0,0,2,98,1,0,0,0
20,5,15,4,20,2,0,0,0
0,0,0,1,20,1,0,0.116666666666667,60
9,9,0,2,68,2,0,0.0147058823529412,68
0,0,0,1,20,1,0,0.0166666666666667,60
67,33,34,4,56,2,0,0,82
4,2,2,1,56,0,0,0,47
10,7,3,2,56,2,0,0,52
4,4,0,2,56,2,0,0,22
27,24,3,1,56,1,0,0,84
15,1,14,1,56,1,0,0,55
161,105,56,2,21,2,1,0.00584795321637427,171
24,9,15,2,28,1,0,0,42
10,7,3,2,56,2,0,0,52
10,7,3,2,56,2,0,0,51
4,3,1,2,3,2,1,0,17
0,0,0,1,23,0,1,0,27
10,9,1,1,29,1,0,0,56
11,11,0,1,29,1,0,0.0126582278481013,79
10,7,3,2,56,2,0,0,51
0,0,0,1,32,1,1,0,18
5,4,1,2,24,1,0,0,61
4,2,2,1,75,1,0,0,51
1,1,0,1,0,1,0,0,29
1,1,0,1,0,1,0,0,52
1,1,0,1,0,1,0,0,68
13,3,10,2,0,1,0,0,135
1,1,0,1,0,1,0,0,252
1,1,0,1,0,1,0,0,65
1,1,0,1,0,1,0,0,42
1,1,0,1,0,1,0,0,53
1,1,0,1,0,1,0,0,116
1,1,0,1,0,1,0,0,62
1,1,0,1,0,1,0,0,73
1,1,0,1,0,1,0,0,345
1,1,0,1,0,1,0,0,62
1,1,0,1,0,1,0,0,134
1,1,0,1,0,1,0,0,153
1,1,0,1,0,1,0,0,151
1,1,0,1,0,1,0,0,69
1,1,0,1,0,1,0,0,108
1,1,0,1,0,1,0,0,58
1,1,0,1,0,1,0,0,400
1,1,0,1,0,1,0,0,464
0,0,0,1,55,1,0,0,0
0,0,0,1,55,1,0,0,0
15,8,7,3,55,1,0,0,0
0,0,0,1,55,1,0,0,0
0,0,0,1,55,1,0,0,0
0,0,0,1,55,1,0,0,0
0,0,0,1,55,1,0,0,0
0,0,0,1,55,1,0,0,0
0,0,0,1,55,1,0,0,0
0,0,0,1,55,1,0,0,0
0,0,0,1,55,1,0,0,0
0,0,0,1,55,1,0,0,0
0,0,0,1,55,1,0,0,0
0,0,0,1,55,1,0,0,0
0,0,0,1,55,1,0,0,0
0,0,0,1,55,1,0,0,0
0,0,0,1,55,1,0,0,0
0,0,0,1,55,1,0,0,0
4,2,2,2,55,2,0,0,0
0,0,0,1,55,1,0,0,0
26,14,12,3,55,1,0,0,0
0,0,0,1,55,1,0,0,0
10,8,2,2,55,1,0,0,0
0,0,0,1,55,1,0,0,0
0,0,0,1,55,1,0,0,0
0,0,0,1,55,1,0,0,0
18,9,9,2,55,1,0,0,0
2,1,1,2,55,1,0,0,0
2,1,1,2,55,1,0,0,0
0,0,0,1,55,1,0,0,0
6,4,2,2,55,1,0,0,0
0,0,0,1,55,1,0,0,0
0,0,0,1,55,1,0,0,0
0,0,0,1,55,1,0,0,0
3,2,1,2,55,1,0,0,0
0,0,0,1,55,1,0,0,0
0,0,0,1,55,1,0,0,0
21,9,12,2,55,1,0,0,0
6,1,5,2,55,1,0,0,0
116,59,57,3,55,2,0,0,0
100,53,47,3,55,2,0,0,0
3,1,2,1,59,0,0,0,59
13,4,9,1,59,0,0,0,140
3,2,1,2,0,2,0,0,236
4,3,1,2,0,2,0,0,221
12,6,6,2,46,2,1,0,24
0,0,0,1,66,1,1,0,19
72,36,36,2,46,2,1,0.00952380952380952,105
16,8,8,3,46,3,1,0,33
24,12,12,3,32,3,1,0,183
0,0,0,1,55,1,0,0,0
0,0,0,1,55,1,0,0,0
0,0,0,1,55,1,0,0,0
2,1,1,2,55,2,0,0,0
0,0,0,1,55,1,0,0,0
0,0,0,1,55,1,0,0,0
0,0,0,1,55,1,0,0,0
0,0,0,1,55,1,0,0,0
0,0,0,1,55,1,0,0,0
0,0,0,1,55,1,0,0,0
2,1,1,1,170,1,0,0.0062111801242236,161
118,66,52,4,74,4,0,0.0078125,128
64,34,30,3,76,3,0,0,179
63,57,6,4,17,2,0,0.0121951219512195,82
103,66,37,9,20,6,1,0,0
78,55,23,6,7,2,2,0.025974025974026,77
35,18,17,5,113,1,0,0,204
0,0,0,1,73,1,0,0.09375,32
314,200,114,12,7,5,0,0.0075187969924812,133
25,1,24,2,132,0,0,0,0
87,46,41,6,7,1,2,0.0208333333333333,48
83,67,16,18,8,11,2,0.078125,64
0,0,0,1,17,1,0,0,44
63,44,19,5,7,4,1,0.0315789473684211,95
228,140,88,13,3,6,1,0.0538461538461538,130
0,0,0,1,78,1,0,0.0869565217391304,23
60,43,17,19,5,13,1,0.0487804878048781,41
136,51,85,8,69,4,3,0,76
0,0,0,1,8,1,0,0.0408163265306122,98
0,0,0,1,46,1,0,0.0185185185185185,54
215,128,87,15,1,7,2,0.0145985401459854,137
63,30,33,6,1,5,0,0.0337837837837838,148
1185,760,425,38,1,22,3,0.0273224043715847,549
719,405,314,27,8,15,3,0.00666666666666667,150
240,139,101,7,21,2,2,0,98
29,26,3,5,1,3,0,0.0555555555555556,54
124,59,65,6,113,2,1,0,0
0,0,0,1,77,1,0,0.0588235294117647,51
138,64,74,3,36,2,0,0.0537634408602151,93
56,26,30,4,67,3,0,0,162
99,66,33,5,36,4,0,0.0540540540540541,111
131,78,53,5,69,1,2,0.0394736842105263,76
0,0,0,2,113,1,0,0,0
167,108,59,11,3,7,0,0.016260162601626,123
48,31,17,7,13,6,0,0.00980392156862745,102
22,16,6,3,69,3,0,0,63
133,85,48,9,14,4,2,0.055045871559633,109
0,0,0,1,8,1,0,0.0303030303030303,66
89,66,23,6,115,0,1,0,0
21,13,8,3,7,2,0,0,48
5,4,1,2,132,0,0,0,19
102,58,44,17,5,11,2,0.0294117647058824,34
0,0,0,2,116,0,0,0,0
94,55,39,8,17,3,1,0.012987012987013,77
22,13,9,5,14,3,1,0.0441176470588235,68
2,1,1,1,170,0,0,0,52
106,37,69,5,2,2,1,0.00578034682080925,519
2,1,1,1,170,0,0,0,54
2,1,1,1,170,0,0,0,54
877,419,458,6,59,2,1,0,456
9,5,4,1,104,0,0,0,67
16,8,8,2,28,1,0,0,66
5,3,2,2,21,1,1,0.00497512437810945,201
2,1,1,1,21,0,0,0,96
0,0,0,1,20,1,0,0,80
9,5,4,2,21,1,1,0.00977198697068404,307
162,49,113,5,21,3,1,0,71
66,28,38,3,21,3,1,0,0
9,7,2,1,21,1,1,0,33
51,22,29,3,21,2,1,0,74
0,0,0,1,75,1,0,0,0
3,2,1,2,13,2,0,0.012987012987013,154
76,45,31,3,21,2,1,0.0166666666666667,120
0,0,0,1,76,1,0,0.0625,16
0,0,0,1,76,1,0,0,61
139,115,24,5,81,4,3,0,0
65,30,35,5,29,5,0,0.00775193798449612,258
100,41,59,6,75,6,2,0,69
0,0,0,2,172,2,0,0,0
0,0,0,1,76,1,0,0,0
0,0,0,1,76,1,0,0,0
0,0,0,1,76,1,0,0,0
313,166,147,6,46,5,1,0,197
2,1,1,2,75,2,0,0,0
32,19,13,2,86,1,0,0,145
185,49,136,7,76,6,2,0,0
182,40,142,6,76,5,2,0,0
30,24,6,2,46,2,0,0.0357142857142857,56
19,18,1,1,146,1,1,0,364
13,8,5,2,130,2,1,0,37
22,0,22,2,125,1,1,0,94
5,2,3,3,73,1,1,0,58
0,0,0,1,127,1,0,0,48
0,0,0,1,146,1,1,0,13
50,19,31,1,146,1,1,0.00520833333333333,192
17,8,9,3,126,1,0,0,69
0,0,0,1,146,1,1,0,26
159,51,108,4,77,2,1,0.00904977375565611,221
6,3,3,3,73,2,0,0,301
12,9,3,3,67,3,0,0,29
49,31,18,5,18,4,1,0,182
51,35,16,5,27,3,0,0,224
14,14,0,3,66,1,1,0,0
14,14,0,3,66,1,1,0,0
221,130,91,6,55,5,0,0.00289855072463768,345
0,0,0,2,17,2,0,0,0
24,10,14,1,142,1,0,0,87
61,18,43,6,20,4,0,0,156
73,40,33,6,55,6,1,0,0
8,4,4,2,55,2,0,0,0
38,9,29,2,66,1,1,0,0
0,0,0,1,55,1,0,0,0
0,0,0,1,55,1,0,0,0
0,0,0,1,55,1,0,0,0
0,0,0,1,55,1,0,0,0
0,0,0,1,55,1,0,0,0
0,0,0,1,55,1,0,0,0
0,0,0,2,55,2,0,0,0
40,7,33,2,66,1,1,0,0
0,0,0,1,55,1,0,0,0
0,0,0,1,55,1,0,0,0
0,0,0,1,55,1,0,0,0
14,14,0,2,55,2,0,0,0
0,0,0,1,55,1,0,0,0
99,67,32,3,10,2,0,0,316
260,116,144,5,56,1,0,0,148
67,48,19,2,84,2,0,0,115
18,15,3,3,7,3,0,0,86
9,8,1,1,16,1,0,0,125
2,1,1,1,170,0,0,0,36
2,1,1,1,170,0,0,0,45
188,103,85,5,24,3,0,0,265
5,3,2,1,67,1,0,0,44
4,2,2,2,127,1,0,0,0
57,14,43,2,146,1,1,0,146
39,21,18,1,146,1,1,0,142
57,39,18,3,13,3,0,0,175
78,17,61,4,32,4,1,0,120
49,21,28,3,127,2,1,0,0
5,2,3,3,14,2,1,0,0
200,118,82,11,14,9,1,0.00793650793650794,126
105,53,52,2,82,2,0,0,71
11,7,4,3,32,3,1,0,0
13,8,5,3,32,3,1,0,0
45,28,17,6,14,5,2,0,55
12,7,5,4,74,4,0,0,0
20,12,8,5,14,4,1,0,0
40,7,33,4,14,2,0,0,0
2,2,0,1,76,1,0,0.00763358778625954,131
3,2,1,1,76,1,0,0,77
1,1,0,1,76,1,0,0,55
1,1,0,1,76,1,0,0,44
1,1,0,1,76,1,0,0,109
1,1,0,1,76,1,0,0,42
2,2,0,1,76,1,0,0,119
17,10,7,3,66,3,1,0,0
26,14,12,3,66,3,1,0,0
35,19,16,3,66,3,1,0,0
164,82,82,3,66,3,1,0,0
288,145,143,3,66,3,1,0,0
2,1,1,1,75,1,0,0,136
0,0,0,1,90,0,1,0,92
57,36,21,2,75,2,0,0,128
78,29,49,7,20,6,0,0,138
2,1,1,1,75,1,0,0,101
93,9,84,1,90,0,1,0,37
94,9,85,1,90,0,1,0,36
2,1,1,1,75,1,0,0,99
81,46,35,2,55,2,0,0,0
0,0,0,1,55,1,0,0,0
168,70,98,2,55,2,0,0,0
5,1,4,2,55,1,0,0,0
0,0,0,1,55,1,0,0,0
2,1,1,2,55,2,0,0,0
924,446,478,12,20,6,0,0.00700525394045534,571
0,0,0,1,27,1,0,0,81
5,2,3,1,32,1,0,0,38
0,0,0,2,27,2,0,0.0123456790123457,81
115,63,52,5,20,3,0,0,266
93,67,26,10,3,7,0,0.0133333333333333,75
14,7,7,5,86,2,0,0,0
38,28,10,5,1,5,0,0.00574712643678161,174
13,10,3,4,20,1,0,0,60
4,2,2,2,46,2,0,0,42
73,53,20,3,34,3,0,0.00917431192660551,109
18,4,14,2,130,0,0,0,142
0,0,0,1,32,1,0,0,70
157,84,73,6,20,4,0,0.00829875518672199,241
13,7,6,3,52,2,0,0,0
0,0,0,1,52,1,0,0,0
0,0,0,1,52,1,0,0,0
6,2,4,2,32,2,0,0,435
93,44,49,5,20,3,0,0.0112359550561798,178
74,34,40,1,130,0,0,0,74
316,145,171,8,15,6,0,0.0133333333333333,150
0,0,0,1,15,1,0,0,11
0,0,0,1,18,1,0,0,55
70,27,43,5,23,4,1,0,42
0,0,0,2,82,2,0,0,0
0,0,0,1,82,1,0,0,66
0,0,0,1,15,1,0,0,76
0,0,0,1,27,1,0,0,90
282,115,167,7,27,7,2,0,49
47,25,22,3,82,3,0,0,39
0,0,0,1,66,1,1,0,50
60,29,31,3,66,3,1,0,0
0,0,0,1,18,1,0,0.00515463917525773,194
0,0,0,1,18,1,0,0,96
0,0,0,1,18,1,0,0,85
0,0,0,1,18,1,0,0,39
0,0,0,1,18,1,0,0,24
0,0,0,1,78,1,0,0,84
6,5,1,2,78,2,0,0,55
0,0,0,1,78,1,0,0,17
187,116,71,11,1,10,1,0.0056980056980057,351
0,0,0,1,163,1,0,0,11
22,17,5,2,156,2,0,0,56
3,3,0,2,156,2,1,0,14
150,138,12,3,70,3,0,0,160
0,0,0,1,163,1,0,0,37
92,55,37,6,70,6,1,0,167
17,14,3,3,70,3,0,0,26
0,0,0,1,163,1,0,0,14
91,38,53,5,20,4,0,0,156
677,203,474,7,70,5,2,0.00478468899521531,209
4,3,1,1,77,1,0,0,32
253,127,126,11,20,7,2,0.00209205020920502,478
36,23,13,6,32,4,0,0.00613496932515337,163
523,257,266,3,42,1,1,0,256
166,119,47,7,24,5,0,0.0112994350282486,177
15,8,7,2,14,2,0,0,0
7,3,4,3,32,3,0,0,210
4,2,2,1,76,1,0,0,77
0,0,0,1,14,0,1,0,24
0,0,0,2,69,2,0,0,0
0,0,0,1,91,1,0,0,83
12,6,6,3,90,3,0,0,0
14,9,5,2,23,1,0,0,273
2,1,1,1,29,1,0,0,105
0,0,0,1,14,0,1,0,46
0,0,0,2,69,2,0,0,0
0,0,0,1,59,1,0,0,10
5,3,2,1,153,1,0,0,43
8,4,4,2,56,2,0,0,39
0,0,0,2,69,2,0,0,0
1,0,1,3,59,2,0,0,0
0,0,0,2,76,1,0,0,0
213,168,45,5,14,5,1,0.00267379679144385,374
535,438,97,9,14,6,1,0.0016366612111293,611
1,0,1,1,127,1,0,0.00943396226415094,106
8,0,8,2,73,0,0,0,47
65,41,24,4,122,1,0,0,237
120,45,75,2,130,2,1,0.00251256281407035,398
5,3,2,1,130,0,0,0,175
2,1,1,2,127,2,0,0,44
2,1,1,1,32,1,0,0,96
29,17,12,3,76,3,1,0,51
65,64,1,1,155,1,0,0,95
29,27,2,1,7,1,0,0,131
481,289,192,12,7,8,2,0.00797872340425532,376
2,1,1,1,81,1,0,0,96
1,1,0,1,130,0,0,0,192
27,23,4,2,88,0,0,0,77
16,7,9,3,21,1,0,0.0277777777777778,36
38,28,10,1,21,1,1,0,137
0,0,0,1,133,0,0,0,0
20,13,7,1,90,1,0,0,121
49,21,28,2,90,0,1,0,72
0,0,0,1,68,1,1,0,85
19,8,11,2,87,2,1,0,38
6,5,1,2,19,2,0,0,79
8,5,3,1,21,1,1,0,68
0,0,0,1,75,1,0,0,270
0,0,0,1,75,1,0,0,25
8,7,1,3,46,3,1,0,24
20,8,12,1,172,0,0,0,129
182,89,93,3,55,2,0,0,0
2,1,1,1,75,1,0,0,122
3,2,1,2,0,2,0,0,264
21,5,16,2,0,2,0,0,286
117,56,61,3,40,2,0,0.00854700854700855,117
18,10,8,2,28,1,0,0,93
70,32,38,3,79,2,0,0,97
0,0,0,1,126,0,0,0,0
51,15,36,1,75,1,0,0,138
12,6,6,2,23,1,0,0.0106382978723404,94
2,1,1,1,75,1,0,0,61
2,0,2,1,55,1,0,0,61
2,1,1,1,75,1,0,0,58
0,0,0,1,52,1,0,0,0
0,0,0,1,98,1,0,0,32
4,0,4,1,28,0,0,0,53
24,12,12,2,21,1,1,0,162
2,0,2,1,55,1,0,0,51
2,1,1,1,75,1,0,0,59
4,0,4,1,21,1,1,0,43
38,22,16,4,67,2,0,0,136
72,30,42,2,24,1,0,0,99
1,1,0,2,67,0,0,0,30
20,8,12,2,28,0,0,0,202
20,10,10,1,133,0,0,0,132
14,7,7,1,133,0,0,0,207
52,28,24,2,52,1,0,0,106
16,8,8,1,133,0,0,0,312
24,13,11,5,55,1,0,0,0
15,8,7,4,55,1,0,0,0
0,0,0,2,55,2,0,0,0
37,18,19,4,55,1,0,0,0
31,13,18,4,55,1,0,0,0
61,40,21,2,55,1,0,0,0
226,169,57,7,55,2,0,0,0
0,0,0,1,55,1,0,0,0
10,8,2,4,55,1,0,0,0
213,205,8,5,55,4,0,0,0
0,0,0,2,55,2,0,0,0
23,17,6,4,55,2,0,0,0
52,41,11,5,55,1,0,0,0
365,182,183,4,55,1,0,0,0
30,5,25,2,28,1,0,0,182
108,45,63,2,75,1,0,0,375
135,55,80,2,75,1,0,0,253
4,2,2,2,66,2,1,0,26
24,12,12,2,46,2,1,0.00826446280991736,121
0,0,0,1,66,1,1,0,100
2,1,1,2,55,1,0,0,0
0,0,0,1,55,1,0,0,0
2,1,1,2,55,1,0,0,0
7,2,5,2,55,2,0,0,0
0,0,0,1,55,1,0,0,0
0,0,0,1,55,1,0,0,0
0,0,0,1,55,1,0,0,0
0,0,0,1,55,1,0,0,0
2,1,1,2,55,1,0,0,0
39,19,20,2,28,1,0,0,165
64,36,28,2,28,1,0,0,167
121,93,28,4,22,2,0,0.0087719298245614,114
0,0,0,1,34,0,0,0.0952380952380952,21
0,0,0,2,115,0,0,0,0
2,1,1,3,115,0,1,0,0
25,12,13,5,23,0,0,0,73
0,0,0,1,46,1,0,0,75
776,588,188,33,1,25,2,0.0425531914893617,423
30,7,23,2,113,0,0,0,73
0,0,0,1,14,0,0,0,35
2,1,1,3,115,0,1,0,0
116,86,30,5,1,2,0,0.0198019801980198,101
38,31,7,4,113,2,1,0,0
43,32,11,3,28,1,0,0.0571428571428571,70
7,3,4,2,84,0,0,0,65
50,44,6,5,36,2,0,0.0365853658536585,82
0,0,0,1,8,1,0,0,25
0,0,0,1,8,1,0,0,27
0,0,0,1,84,1,0,0.0140845070422535,71
20,10,10,1,34,1,0,0,385
4,2,2,1,98,0,0,0.00366300366300366,273
12,2,10,2,55,1,0,0,57
6,3,3,2,21,1,1,0,115
8,2,6,1,75,1,0,0,70
6,3,3,1,75,1,0,0,86
8,2,6,1,75,1,0,0,70
15,3,12,3,73,1,0,0,69
226,26,200,2,21,2,1,0,57
115,59,56,4,21,3,1,0,258
5,3,2,1,21,1,1,0,131
39,15,24,3,21,3,1,0,78
26,8,18,2,21,2,1,0,129
10,7,3,2,21,2,1,0.00204918032786885,488
27,18,9,5,21,4,0,0,77
31,13,18,4,21,3,1,0,148
10,1,9,2,81,2,1,0,102
70,44,26,4,28,3,0,0,213
0,0,0,1,76,1,0,0,0
111,63,48,6,28,5,1,0,301
46,14,32,3,76,3,1,0,0
62,25,37,6,46,6,0,0,290
0,0,0,1,76,1,0,0,0
32,11,21,5,75,4,1,0,75
13,7,6,2,81,2,1,0,0
0,0,0,2,76,2,0,0,0
0,0,0,1,76,1,0,0,0
22,5,17,3,28,1,1,0,142
0,0,0,1,146,1,1,0.0666666666666667,15
3,3,0,1,146,1,1,0,87
0,0,0,1,146,1,1,0,0
3,3,0,2,127,2,1,0,66
0,0,0,1,126,0,0,0.0136986301369863,73
26,13,13,1,146,1,1,0.00934579439252336,107
0,0,0,1,127,1,0,0.00746268656716418,134
0,0,0,1,67,1,0,0,28
54,25,29,3,74,1,1,0.0194174757281553,103
4,0,4,1,28,0,0,0,157
267,147,120,3,97,2,0,0.00354609929078014,282
8,0,8,1,28,0,0,0,200
161,61,100,5,55,4,0,0,0
0,0,0,1,55,1,0,0,0
10,5,5,2,55,1,0,0,0
2,1,1,2,55,1,0,0,0
2,1,1,3,55,2,0,0,0
14,7,7,2,66,1,0,0,0
0,0,0,1,55,1,0,0,0
0,0,0,1,55,1,0,0,0
0,0,0,1,55,1,0,0,0
0,0,0,1,55,1,0,0,0
0,0,0,1,55,1,0,0,0
98,37,61,3,17,1,1,0,532
0,0,0,1,17,1,1,0,25
51,26,25,1,52,1,0,0,97
68,20,48,1,84,1,0,0,68
8,7,1,2,7,2,0,0,71
8,7,1,2,7,2,0,0,61
89,42,47,4,67,2,0,0,177
24,11,13,1,146,1,1,0,97
44,31,13,1,40,1,0,0,106
3,3,0,1,127,1,0,0,48
13,7,6,2,122,2,1,0,64
55,11,44,3,73,2,1,0,143
3,1,2,2,127,2,1,0,0
66,39,27,5,14,4,1,0,114
0,0,0,1,83,1,0,0,57
11,6,5,3,32,3,1,0,80
5,3,2,3,14,2,1,0,52
4,2,2,1,133,0,0,0,82
6,3,3,1,133,0,0,0,111
74,24,50,5,14,3,1,0,0
4,4,0,1,46,1,0,0,52
6,2,4,2,46,2,0,0,106
44,25,19,2,52,1,0,0,89
0,0,0,2,66,2,1,0,0
0,0,0,2,66,2,1,0,0
0,0,0,2,66,2,1,0,0
15,4,11,1,75,1,0,0,148
62,31,31,2,75,2,0,0,222
64,15,49,4,28,3,0,0,297
8,2,6,1,75,1,0,0,153
20,2,18,1,90,0,1,0,153
15,3,12,1,90,0,1,0,160
19,3,16,1,75,1,0,0,144
16,8,8,2,55,1,0,0,0
82,31,51,3,55,2,0,0,0
0,0,0,1,55,1,0,0,0
0,0,0,1,55,1,0,0,0
0,0,0,1,55,1,0,0,0
0,0,0,1,55,1,0,0,0
0,0,0,1,55,1,0,0,0
0,0,0,1,55,1,0,0,0
24,12,12,2,55,1,0,0,0
205,180,25,9,46,7,0,0.00151745068285281,659
37,8,29,3,75,1,0,0,341
46,40,6,2,19,2,0,0.0126582278481013,158
61,18,43,2,98,1,0,0,288
0,0,0,1,52,1,0,0,0
0,0,0,1,52,1,0,0,0
0,0,0,1,52,1,0,0,0
4,2,2,1,133,0,0,0,447
20,8,12,3,32,3,1,0,68
10,5,5,3,78,2,0,0,0
0,0,0,1,79,0,0,0,42
38,12,26,2,83,2,0,0,65
0,0,0,1,15,1,0,0,83
35,17,18,6,27,6,2,0.00675675675675676,148
0,0,0,1,83,1,0,0,49
8,4,4,2,66,2,1,0,34
0,0,0,1,78,1,0,0,48
61,34,27,5,70,5,1,0,284
21,12,9,4,67,1,0,0,135
58,43,15,5,23,4,1,0,127
86,34,52,3,28,2,0,0.0045662100456621,219
58,24,34,2,70,2,1,0.00498753117206983,401
94,85,9,4,69,3,1,0.00206611570247934,484
66,47,19,1,68,1,1,0,259
53,42,11,3,97,1,0,0,150
41,4,37,3,14,1,0,0,0
0,0,0,1,67,1,0,0,36
37,21,16,2,29,1,0,0,175
28,1,27,3,59,2,0,0,0
40,27,13,2,96,1,0,0,195
190,167,23,8,67,7,0,0,319
56,24,32,2,130,2,1,0.0102564102564103,195
0,0,0,1,127,1,0,0,56
10,5,5,1,133,0,0,0,130
20,10,10,1,133,0,0,0,103
10,5,5,1,133,0,0,0,101
0,0,0,1,155,1,0,0,63
215,129,86,8,46,7,2,0.00909090909090909,220
4,0,4,1,28,0,0,0,249
10,1,9,1,90,0,1,0,90
18,9,9,1,133,0,0,0,152
0,0,0,1,75,1,0,0,274
21,6,15,2,28,1,0,0,154
9,3,6,1,75,1,0,0,116
236,110,126,4,21,2,1,0,471
63,14,49,2,28,1,0,0,149
2,1,1,1,75,1,0,0,68
2,1,1,1,75,1,0,0,61
2,0,2,1,28,0,0,0,40
56,13,43,2,28,1,0,0,170
5,3,2,1,132,0,0,0,86
10,5,5,1,133,0,0,0,128
0,0,0,1,142,0,0,0,0
89,52,37,6,32,3,0,0.00194931773879142,513
26,17,9,1,142,1,0,0,57
23,14,9,2,142,2,1,0,109
0,0,0,1,142,1,0,0,50
0,0,0,1,78,0,0,0,36
50,27,23,4,59,2,0,0,105
0,0,0,1,78,0,0,0,69
8,2,6,3,66,1,0,0,84
2,1,1,2,25,2,0,0.0099009900990099,202
0,0,0,1,45,1,0,0,34
0,0,0,2,73,0,0,0,0
0,0,0,1,78,0,0,0.0277777777777778,36
0,0,0,1,78,0,0,0,32
0,0,0,2,73,0,0,0,0
56,34,22,6,45,1,0,0,0
0,0,0,2,45,1,0,0,0
0,0,0,1,45,1,0,0.00746268656716418,134
0,0,0,2,45,1,0,0,0
0,0,0,2,66,1,0,0,0
34,24,10,2,66,1,0,0,206
0,0,0,1,45,1,0,0,35
0,0,0,2,45,1,0,0,0
0,0,0,2,73,0,0,0,0
0,0,0,1,78,0,0,0.0128205128205128,78
1,0,1,1,26,1,1,0,437
8,4,4,3,26,3,2,0,0
0,0,0,1,26,1,1,0,0
0,0,0,1,26,1,1,0,0
0,0,0,1,28,1,1,0,0
0,0,0,1,28,1,1,0,0
0,0,0,1,28,1,1,0,0
0,0,0,1,26,1,1,0,0
0,0,0,1,26,1,1,0,0
2,1,1,2,26,2,1,0,33
0,0,0,1,26,1,1,0,37
0,0,0,1,26,1,1,0,27
43,2,41,2,14,1,1,0,0
69,43,26,3,14,2,1,0,322
24,12,12,1,26,1,1,0,372
0,0,0,1,26,1,1,0,0
0,0,0,1,26,1,1,0,0
40,12,28,2,14,2,1,0.00892857142857143,112
66,28,38,2,28,2,1,0,0
12,6,6,2,26,2,1,0,0
0,0,0,1,26,1,1,0,0
0,0,0,1,26,1,1,0,0
15,8,7,1,26,1,1,0.00350877192982456,285
30,18,12,4,111,0,0,0,197
0,0,0,1,77,1,0,0,7
6,3,3,1,133,0,0,0,150
4,2,2,1,9,1,1,0,195
57,40,17,3,9,1,1,0,282
4,0,4,1,59,0,0,0,62
12,4,8,2,59,0,0,0,181
20,10,10,1,133,0,1,0,149
2,1,1,1,133,0,1,0,115
26,13,13,2,9,1,2,0,88
16,8,8,2,9,1,2,0,61
10,5,5,1,133,0,1,0,91
6,3,3,1,133,0,1,0,57
0,0,0,1,73,0,0,0,6
0,0,0,1,26,1,0,0,41
0,0,0,1,122,0,0,0,51
0,0,0,1,122,0,0,0,7
0,0,0,1,122,0,0,0,32
4,2,2,2,17,0,0,0,15
7,6,1,2,13,0,0,0,40
0,0,0,1,122,0,0,0,21
4,2,2,2,122,0,0,0,34
6,3,3,2,122,0,0,0,39
0,0,0,1,16,1,0,0,60
0,0,0,1,16,1,0,0,58
0,0,0,1,16,1,0,0,79
0,0,0,1,16,1,0,0,152
0,0,0,1,16,1,0,0,394
0,0,0,1,16,1,0,0,57
0,0,0,1,16,1,0,0,105
0,0,0,1,16,1,0,0,35
0,0,0,1,16,1,0,0,140
0,0,0,1,16,1,0,0,50
0,0,0,1,16,1,0,0,63
0,0,0,1,16,1,0,0,84
0,0,0,1,16,1,0,0,117
0,0,0,1,16,1,0,0,228
0,0,0,1,16,1,0,0,386
0,0,0,1,16,1,0,0,106
0,0,0,1,16,1,0,0,114
0,0,0,1,16,1,0,0,35
0,0,0,1,16,1,0,0,72
0,0,0,1,78,0,0,0,0
18,7,11,2,78,0,1,0,0
0,0,0,1,78,0,0,0,0
0,0,0,1,78,0,0,0,0
0,0,0,1,78,0,0,0,0
0,0,0,1,78,0,0,0,0
0,0,0,1,78,0,0,0,0
0,0,0,1,87,0,0,0,0
6,5,1,2,78,0,0,0,0
4,4,0,2,78,0,0,0,0
14,14,0,2,78,0,0,0,0
0,0,0,1,89,0,1,0,0
0,0,0,1,78,0,0,0,0
6,2,4,2,78,0,1,0,0
28,13,15,2,78,0,1,0,0
14,14,0,3,78,1,0,0,0
10,3,7,2,78,0,1,0,0
0,0,0,1,78,0,0,0,0
0,0,0,2,16,2,1,0,0
2,1,1,1,170,0,0,0,91
2,1,1,1,170,0,0,0,49
2,1,1,1,170,0,0,0,360
11,6,5,1,124,0,0,0,77
0,0,0,1,16,1,0,0,51
2,1,1,1,170,0,0,0,128
2,1,1,2,134,0,0,0,0
0,0,0,1,134,0,0,0,0
0,0,0,1,134,0,0,0,0
2,1,1,2,134,0,0,0,0
2,1,1,2,134,0,0,0,0
2,1,1,2,134,0,0,0,0
0,0,0,1,134,0,0,0,0
0,0,0,1,134,0,0,0,0
0,0,0,1,134,0,0,0,0
0,0,0,1,134,0,0,0,0
0,0,0,1,134,0,0,0,0
0,0,0,1,134,0,0,0,0
0,0,0,1,134,0,0,0,0
0,0,0,1,134,0,0,0,0
0,0,0,1,134,0,0,0,0
0,0,0,1,134,0,0,0,0
0,0,0,1,134,0,0,0,0
0,0,0,1,134,0,0,0,0
0,0,0,1,134,0,0,0,0
0,0,0,1,134,0,0,0,0
0,0,0,1,134,0,0,0,0
0,0,0,1,134,0,0,0,0
0,0,0,1,134,0,0,0,0
2,1,1,2,134,0,0,0,0
2,1,1,2,134,0,0,0,0
0,0,0,1,134,0,0,0,0
0,0,0,1,134,0,0,0,0
0,0,0,1,134,0,0,0,0
2,1,1,2,134,0,0,0,0
0,0,0,1,134,0,0,0,0
0,0,0,1,134,0,0,0,0
0,0,0,1,134,0,0,0,0
0,0,0,1,134,0,0,0,0
0,0,0,1,134,0,0,0,0
0,0,0,1,134,0,0,0,0
0,0,0,1,134,0,0,0,0
0,0,0,1,134,0,0,0,0
0,0,0,1,134,0,0,0,0
0,0,0,1,134,0,0,0,0
0,0,0,1,134,0,0,0,0
0,0,0,1,134,0,0,0,0
0,0,0,1,134,0,0,0,0
0,0,0,1,134,0,0,0,0
0,0,0,1,55,1,0,0,234
0,0,0,1,55,1,0,0,211
0,0,0,1,55,1,0,0.0148148148148148,135
0,0,0,1,55,1,0,0,225
0,0,0,1,55,1,0,0,102
0,0,0,1,55,1,0,0,212
1,0,1,2,28,1,0,0,181
0,0,0,1,55,1,0,0,126
0,0,0,1,55,1,0,0,98
6,5,1,2,29,2,0,0,95
0,0,0,1,55,1,0,0,83
0,0,0,1,55,1,0,0,113
0,0,0,1,55,1,0,0,95
0,0,0,1,55,1,0,0,104
0,0,0,1,55,1,0,0,246
