CODECHURN,LOCADDED,LOCDELETED,REVISIONS,AGE,BUGFIXES,REFACTORINGS,ERROR_DENSITY,LOC
45,29,16,3,77,0,0,0.00219106047326906,2282
41,39,2,2,37,0,0,0.000788643533123028,1268
21,13,8,3,63,1,0,0,208
6,4,2,1,114,1,0,0,557
270,157,113,15,11,5,0,0,2202
83,47,36,2,32,0,0,0.00166500166500167,3003
38,28,10,1,75,1,0,0.000959692898272553,1042
182,139,43,3,3,3,0,0.00373134328358209,2412
40,27,13,2,57,0,0,0.00171821305841924,582
850,510,340,14,6,7,0,0.00232468035645099,5162
56,52,4,2,0,2,0,0.00128865979381443,1552
7,6,1,1,0,1,0,0.00113378684807256,1764
87,78,9,3,0,3,0,0.00365764447695684,1367
115,90,25,10,0,3,0,0.00194552529182879,1028
630,354,276,22,10,4,0,0.00225069252077562,5776
54,33,21,3,86,3,0,0.00347624565469293,1726
15,10,5,3,100,2,1,0,71
31,27,4,3,97,1,0,0.00597014925373134,335
6,4,2,1,108,1,0,0,210
4,1,3,1,100,0,0,0,166
17,13,4,2,7,1,0,0.00448430493273543,223
3,2,1,1,150,0,0,0,91
5,4,1,1,157,0,0,0,256
34,17,17,8,0,0,0,0,15
31,28,3,2,166,1,0,0,186
46,37,9,2,164,2,0,0,323
184,84,100,10,0,5,0,0.00296833773087071,3032
30,19,11,3,122,1,0,0.00164473684210526,608
310,184,126,12,0,5,0,0.00180686609114636,4981
47,31,16,2,32,0,0,0.00221075902726603,1357
4,3,1,1,114,0,0,0.00137741046831956,726
62,42,20,1,50,1,0,0,1173
129,109,20,7,0,5,0,0.00340425531914894,1175
6,3,3,1,0,1,0,0,373
180,136,44,8,10,1,0,0,901
23,20,3,1,2,1,0,0.00434782608695652,1380
26,15,11,2,59,1,0,0.00351288056206089,2562
322,229,93,15,32,9,1,0.00161759948236817,3091
152,81,71,7,0,3,0,0.00265076209410205,1509
6,4,2,1,124,0,0,0,252
7,4,3,1,32,0,0,0.00125786163522013,1590
343,212,131,10,64,8,1,0,1383
295,204,91,13,28,6,0,0.00285714285714286,3150
106,71,35,2,166,1,0,0.014792899408284,338
114,81,33,9,8,2,0,0.0022883295194508,437
169,110,59,6,24,1,0,0.00106269925611052,3764
9,4,5,1,124,0,0,0,144
95,28,67,5,63,1,0,0.0016246953696182,1231
52,22,30,4,51,2,0,0.00461538461538462,650
252,157,95,19,22,5,0,0.0032797638570023,3049
27,21,6,2,60,1,0,0,292
11,8,3,1,124,0,0,0,848
217,157,60,5,80,3,0,0.000797448165869219,1254
17,7,10,1,154,0,0,0.00160513643659711,623
111,80,31,4,124,1,0,0,736
16,11,5,1,32,0,0,0,285
18,13,5,1,132,0,0,0,298
50,34,16,3,9,0,0,0,1002
43,29,14,2,14,0,0,0.00137931034482759,725
14,9,5,1,46,1,0,0,1081
13,7,6,2,157,0,0,0,328
40,26,14,1,124,0,0,0,479
18,11,7,3,51,0,0,0.00293255131964809,341
0,0,0,1,122,0,0,0,410
0,0,0,1,122,0,0,0,461
0,0,0,1,122,0,0,0,176
0,0,0,1,122,0,0,0,220
0,0,0,1,122,0,0,0,409
0,0,0,1,122,0,0,0,155
0,0,0,1,122,0,0,0,509
0,0,0,1,122,0,0,0,593
0,0,0,1,122,0,0,0,488
4,2,2,2,6,1,0,0,152
0,0,0,1,122,0,0,0,87
0,0,0,1,122,0,0,0,1216
0,0,0,1,122,0,0,0,468
0,0,0,1,122,0,0,0,628
0,0,0,1,122,0,0,0,54
0,0,0,1,122,0,0,0,614
10,7,3,3,91,0,0,0,180
0,0,0,1,122,0,0,0,72
0,0,0,1,122,0,0,0,247
0,0,0,1,122,0,0,0,315
0,0,0,1,122,0,0,0,77
32,29,3,2,122,0,0,0,0
0,0,0,1,122,0,0,0,0
0,0,0,1,122,0,0,0,0
0,0,0,1,122,0,0,0,0
0,0,0,1,122,0,0,0,0
0,0,0,1,122,0,0,0,0
0,0,0,1,122,0,0,0,0
0,0,0,1,122,0,0,0,0
0,0,0,1,122,0,0,0,0
0,0,0,1,122,0,0,0,0
0,0,0,1,122,0,0,0,0
0,0,0,1,122,0,0,0,0
0,0,0,1,122,0,0,0,0
0,0,0,1,122,0,0,0,0
0,0,0,1,122,0,0,0,0
0,0,0,1,117,0,0,0,34
1827,1635,192,46,56,7,0,0,1510
701,622,79,28,56,10,0,0,868
4230,3958,272,9,115,3,0,0,0
1343,1268,75,6,77,3,0,0.00144822592324403,1381
83,42,41,4,77,0,0,0,171
245,171,74,4,77,0,0,0,941
152,75,77,4,77,0,0,0,290
292,145,147,4,77,0,0,0,558
222,110,112,5,77,0,0,0,446
360,293,67,4,77,0,0,0,1028
593,551,42,5,77,0,0,0,753
98,68,30,5,56,0,0,0.00485436893203883,206
45,32,13,3,77,0,0,0.00531914893617021,188
318,227,91,6,77,0,0,0.0051622418879056,1356
222,110,112,4,77,0,0,0,444
0,0,0,1,64,0,0,0.00328947368421053,304
136,133,3,2,51,0,0,0.00230414746543779,434
595,429,166,7,34,0,0,0,824
0,0,0,1,71,0,0,0.00225733634311512,1329
4,2,2,2,59,0,0,0.00443786982248521,676
278,138,140,4,77,0,0,0,547
935,551,384,6,77,1,0,0.00444115470022206,1351
52,22,30,4,77,0,0,0,141
109,79,30,4,77,0,0,0,419
118,55,63,5,77,0,0,0,266
371,182,189,4,77,0,0,0,771
153,75,78,4,77,0,0,0,289
83,42,41,4,77,0,0,0,171
318,154,164,4,77,0,0,0,646
395,243,152,6,77,0,0,0,1187
302,148,154,4,77,0,0,0,557
209,109,100,4,77,1,0,0,439
551,275,276,6,77,1,0,0,1010
318,147,171,4,77,0,0,0,580
224,159,65,4,77,0,0,0,940
155,111,44,4,77,1,0,0,681
279,138,141,4,77,0,0,0,545
52,22,30,4,77,0,0,0,141
123,47,76,4,77,0,0,0,326
78,56,22,4,59,0,0,0,293
0,0,0,1,60,1,0,0,379
0,0,0,1,57,0,0,0,201
0,0,0,2,55,0,0,0,0
1150,1143,7,4,57,2,0,0.000656598818122127,1523
222,217,5,2,54,0,0,0,511
14,10,4,2,56,2,0,0.00485436893203883,412
36,24,12,4,77,0,0,0.00732600732600733,273
57,32,25,3,77,0,0,0.0025062656641604,399
2,2,0,2,56,1,0,0,271
307,299,8,6,56,4,0,0,688
27,7,20,2,57,0,0,0,492
1,0,1,2,57,0,0,0.005,200
1057,1038,19,6,13,2,0,0.000811688311688312,1232
931,905,26,3,63,2,0,0,1505
0,0,0,1,73,0,0,0,156
40,23,17,3,77,0,0,0,297
46,26,20,3,77,0,0,0,332
46,26,20,3,77,0,0,0,312
0,0,0,1,57,0,0,0,325
64,36,28,2,77,0,0,0,543
49,29,20,3,77,0,0,0.00193050193050193,518
0,0,0,1,57,0,0,0,196
38,22,16,2,77,0,0,0,322
38,22,16,2,77,0,0,0,295
38,22,16,2,77,0,0,0,307
38,22,16,2,77,0,0,0,311
38,22,16,2,77,0,0,0,331
64,36,28,2,77,0,0,0,539
13,3,10,2,57,0,0,0,339
179,172,7,2,2,2,0,0.0141414141414141,495
0,0,0,1,61,0,0,0,1215
351,227,124,8,77,2,0,0.00309597523219814,323
42,24,18,2,77,0,0,0.00279329608938547,358
106,105,1,2,28,0,0,0.00386100386100386,259
121,121,0,2,44,0,0,0,940
3465,3413,52,7,19,1,0,0.000707881075979236,4238
479,473,6,4,3,3,0,0.00405844155844156,1232
0,0,0,1,57,0,0,0,575
14,9,5,2,60,0,0,0,52
1120,1058,62,8,49,5,0,0.00574712643678161,1044
165,164,1,3,30,0,0,0.0146627565982405,341
0,0,0,1,57,0,0,0,199
168,90,78,3,77,0,0,0.000649772579597141,1539
139,75,64,3,77,0,0,0.00131061598951507,1526
0,0,0,1,59,0,0,0,133
0,0,0,1,75,0,0,0,145
0,0,0,1,59,0,0,0,133
28,18,10,5,75,0,0,0,112
0,0,0,1,122,0,0,0,0
0,0,0,1,122,0,0,0,0
0,0,0,1,122,0,0,0,0
282,224,58,67,56,8,0,0.0226244343891403,221
0,0,0,1,122,0,0,0,0
0,0,0,1,122,0,0,0,0
0,0,0,1,122,0,0,0,0
