CODECHURN,LOCADDED,LOCDELETED,REVISIONS,AGE,BUGFIXES,REFACTORINGS,ERROR_DENSITY,LOC
8,7,1,1,62,1,0,0.00222222222222222,450
22,18,4,2,91,1,0,0,507
1,0,1,1,178,1,0,0,774
4,2,2,2,129,2,0,0,0
14,7,7,4,129,3,0,0,0
11,8,3,2,15,1,0,0,205
301,195,106,7,40,5,0,0.00174621653084983,1718
36,18,18,4,56,0,0,0.0131578947368421,76
48,36,12,9,8,5,0,0.00520833333333333,384
163,120,43,8,0,4,0,0.000915750915750916,3276
8,5,3,2,110,1,0,0,132
100,77,23,7,17,4,0,0.00135931128228364,2207
136,109,27,10,26,7,0,0.00995575221238938,904
13,9,4,2,8,2,0,0.00140845070422535,710
66,29,37,4,8,4,0,0.000866551126516464,1154
6,3,3,1,23,1,0,0.00584795321637427,171
9,6,3,2,107,0,0,0.0104166666666667,96
136,81,55,8,15,5,0,0.00420757363253857,1426
13,8,5,4,15,3,0,0.00930232558139535,215
114,95,19,7,9,7,0,0.001041305102395,2881
43,28,15,5,8,3,0,0.000573394495412844,1744
6,3,3,1,43,0,0,0.00224215246636771,446
24,8,16,1,5,0,0,0.00278551532033426,359
74,72,2,1,86,1,0,0.00169779286926995,589
49,24,25,1,89,0,0,0,621
0,0,0,1,5,0,0,0,0
191,173,18,3,5,2,0,0,426
162,119,43,5,23,4,0,0.00168161434977578,1784
6,3,3,1,81,0,0,0.0101522842639594,197
25,13,12,2,29,1,0,0,82
45,29,16,2,29,1,0,0,771
2,1,1,1,176,1,0,0.00704225352112676,142
155,122,33,16,22,5,0,0.00663716814159292,1808
13,7,6,4,18,4,0,0.0102040816326531,196
16,9,7,4,15,2,0,0.00483091787439614,207
42,21,21,2,1,1,0,0,112
6,1,5,1,43,0,0,0.00888888888888889,225
59,53,6,4,27,2,0,0,723
5,2,3,1,62,1,0,0.00132978723404255,1504
10,5,5,2,47,2,0,0,191
157,150,7,3,27,1,0,0,1081
22,21,1,1,27,0,0,0,62
0,0,0,1,178,1,0,0.0140845070422535,71
12,9,3,3,23,2,0,0.000871839581517001,1147
2,2,0,1,178,1,0,0,115
475,348,127,17,17,12,0,0.00127226463104326,3144
7,5,2,2,91,2,0,0.00137362637362637,728
100,67,33,6,15,5,0,0.00303951367781155,987
14,7,7,1,26,1,0,0.000553097345132743,1808
12,6,6,2,26,1,0,0,257
14,9,5,3,62,2,0,0,201
62,57,5,4,55,1,0,0,134
52,37,15,3,58,2,0,0.0125786163522013,159
4,2,2,1,11,1,0,0,286
37,30,7,2,8,2,0,0,383
0,0,0,1,138,0,0,0,57
4,2,2,2,129,2,0,0,0
20,6,14,2,29,2,0,0,233
11,7,4,3,10,2,0,0.00129533678756477,772
4,2,2,1,147,0,0,0,435
126,34,92,4,29,3,0,0.00132216835610401,2269
4,2,2,1,147,0,0,0,87
7,5,2,2,10,1,0,0,727
7,3,4,1,38,1,0,0,986
1,1,0,1,124,0,0,0,72
1,0,1,1,124,0,0,0,226
53,28,25,5,23,2,0,0.00255972696245734,1172
19,11,8,4,8,3,0,0,99
4,2,2,2,129,2,0,0,0
4,2,2,1,147,0,0,0,37
66,34,32,6,26,3,0,0.0253164556962025,79
10,5,5,2,26,1,0,0,36
4,2,2,1,147,0,0,0,54
4,2,2,1,147,0,0,0,60
67,37,30,3,24,1,0,0,224
4,2,2,1,147,0,0,0,33
4,2,2,1,147,0,0,0,409
4,2,2,1,147,0,0,0,88
4,2,2,2,47,1,0,0,0
4,2,2,2,47,1,0,0,0
21,11,10,2,110,0,0,0.00558659217877095,179
4,2,2,1,147,0,0,0,59
35,29,6,4,38,2,0,0.00486223662884927,617
9,6,3,2,38,0,0,0.0289855072463768,138
7,4,3,2,110,0,0,0.000632911392405063,1580
4,2,2,1,147,0,0,0,86
97,69,28,4,69,2,0,0.0142857142857143,210
4,2,2,1,147,0,0,0,35
21,9,12,2,110,0,0,0.00578034682080925,346
4,2,2,1,147,0,0,0,46
4,2,2,1,147,0,0,0,43
0,0,0,1,69,0,0,0,75
0,0,0,1,69,0,0,0,44
42,29,13,3,142,2,0,0.00198412698412698,504
4,2,2,1,147,0,0,0,105
192,154,38,2,8,1,0,0.00210526315789474,475
4,2,2,1,147,0,0,0.0294117647058824,34
4,2,2,1,147,0,0,0,315
4,2,2,1,147,0,0,0,38
4,2,2,1,147,0,0,0,131
4,2,2,1,147,0,0,0,55
9,3,6,2,147,0,0,0,83
86,50,36,5,69,3,0,0.00684931506849315,146
4,2,2,1,147,0,0,0,34
30,11,19,2,69,1,0,0.0019723865877712,507
4,2,2,1,147,0,0,0,33
669,567,102,11,8,9,0,0.00335570469798658,2086
32,18,14,3,47,1,0,0.0392156862745098,51
4,2,2,1,147,0,0,0,100
36,19,17,5,47,3,0,0.00925925925925926,216
8,4,4,2,91,1,0,0,81
530,203,327,4,47,2,0,0.00288184438040346,1041
9,3,6,2,69,1,0,0,41
4,2,2,1,147,0,0,0,126
4,2,2,1,147,0,0,0,31
4,2,2,1,147,0,0,0,43
42,31,11,5,26,4,0,0,143
26,17,9,4,15,3,0,0,59
1412,901,511,10,11,7,0,0.00168804861580013,2962
4,2,2,1,147,0,0,0,33
12,9,3,2,44,1,0,0.00269179004037685,743
4,2,2,1,147,0,0,0,37
4,2,2,1,147,0,0,0,31
159,100,59,10,15,8,0,0.00170502983802217,2346
4,2,2,1,147,0,0,0,33
4,2,2,1,147,0,0,0,41
73,42,31,5,47,4,0,0,2454
147,83,64,10,8,8,0,0.0149253731343284,335
4,2,2,1,147,0,0,0,34
61,42,19,5,8,3,0,0.00733496332518337,409
4,2,2,1,147,0,0,0.0104166666666667,96
4,2,2,1,147,0,0,0.0144927536231884,69
4,2,2,1,147,0,0,0,235
4,2,2,1,147,0,0,0,33
74,37,37,12,8,8,0,0.153846153846154,39
4,2,2,1,147,0,0,0,506
4,2,2,1,147,0,0,0,45
4,2,2,1,147,0,0,0,46
8,4,4,2,69,1,0,0,56
111,91,20,2,69,1,0,0,381
4,2,2,1,147,0,0,0,75
4,2,2,1,147,0,0,0,303
4,2,2,1,147,0,0,0,42
4,2,2,1,147,0,0,0,86
4,2,2,1,147,0,0,0,48
0,0,0,1,24,1,0,0,52
0,0,0,1,24,1,0,0,35
11,8,3,3,129,2,0,0,0
53,32,21,8,8,7,0,0.00447427293064877,447
44,21,23,6,8,3,0,0.00167644593461861,1193
10,5,5,2,91,1,0,0,262
110,68,42,1,8,1,0,0.00261780104712042,382
397,268,129,8,31,3,0,0.00338409475465313,1182
46,15,31,2,73,1,0,0,102
914,519,395,24,8,18,0,0.00391006842619746,3069
4,2,2,1,147,0,0,0,84
86,59,27,5,29,4,0,0.021551724137931,232
57,29,28,2,26,2,0,0,76
131,74,57,7,53,5,0,0.000672494956287828,1487
94,46,48,2,145,2,0,0,199
4,2,2,1,147,0,0,0,41
436,291,145,7,91,3,0,0.00101626016260163,984
410,308,102,15,8,11,0,0.00677966101694915,590
725,538,187,11,8,7,0,0.00528301886792453,1325
10,5,5,2,91,1,0,0.0151515151515152,264
105,65,40,1,8,1,0,0.00263157894736842,380
832,509,323,13,31,9,0,0.000611620795107034,1635
7,6,1,2,73,1,0,0,106
7,7,0,2,73,1,0,0,64
753,455,298,21,2,13,0,0.00416933932007697,3118
4,2,2,1,147,0,0,0,84
86,59,27,5,29,4,0,0.0136986301369863,219
57,29,28,2,26,2,0,0.0131578947368421,76
1287,719,568,5,31,3,0,0.00245098039215686,1632
2,1,1,2,73,1,0,0,261
4,2,2,1,147,0,0,0,41
965,527,438,6,91,4,0,0.00114678899082569,872
10,5,5,3,129,2,0,0,0
10,8,2,1,178,1,0,0,177
5,1,4,1,24,1,0,0,1738
124,112,12,3,18,3,0,0.00238095238095238,420
5,1,4,1,24,1,0,0,282
21,12,9,1,178,1,0,0.00325732899022801,307
1357,1032,325,9,8,8,0,0.00040821880527963,7349
149,145,4,2,18,2,0,0.00183823529411765,544
9,3,6,1,24,1,0,0.00193050193050193,518
222,113,109,2,18,2,0,0.000910746812386157,1098
2,1,1,1,8,0,0,0.00325732899022801,307
112,63,49,1,24,1,0,0,413
19,16,3,4,29,4,0,0.0116279069767442,86
0,0,0,1,106,0,0,0,0
539,255,284,5,29,5,0,0.00139664804469274,2148
4,2,2,2,26,2,0,0,258
1,1,0,1,178,1,0,0,126
193,97,96,2,107,2,0,0.00146198830409357,684
291,180,111,3,107,3,0,0.00367647058823529,272
26,15,11,3,29,3,0,0,96
290,236,54,2,62,2,0,0.00389105058365759,257
48,32,16,6,18,6,0,0,411
4,2,2,2,129,2,0,0,0
10,7,3,2,29,2,0,0,110
172,61,111,5,29,5,0,0.000533333333333333,1875
7,2,5,2,26,2,0,0,384
1,1,0,1,178,1,0,0,96
9,7,2,2,107,2,0,0,298
4,2,2,2,129,2,0,0,0
3,2,1,1,29,1,0,0,509
47,23,24,5,29,4,0,0.00233644859813084,1284
455,344,111,4,29,4,0,0.00481695568400771,1038
11,7,4,3,129,2,0,0,0
4,2,2,2,129,2,0,0,0
114,45,69,5,17,4,0,0.00177777777777778,1125
0,0,0,1,122,0,0,0,0
86,84,2,1,122,0,0,0,232
4,2,2,2,122,1,0,0,0
0,0,0,1,122,0,0,0,0
4,2,2,2,129,2,0,0,0
168,98,70,12,9,5,0,0.00289855072463768,345
13,8,5,2,53,1,0,0,297
468,242,226,9,31,1,0,0,1726
4,2,2,1,122,0,0,0,58
1924,1291,633,29,4,14,0,0.00107787658313123,3711
175,117,58,6,9,3,0,0.000753012048192771,1328
501,120,381,6,3,3,0,0.000669792364367046,1493
114,25,89,4,9,1,0,0,480
10,5,5,2,29,1,0,0,3205
41,25,16,1,162,1,0,0,165
236,157,79,9,17,5,0,0,528
12,5,7,2,122,1,0,0,64
1066,649,417,18,45,11,0,0.00170212765957447,1175
814,433,381,16,17,7,0,0.00345423143350604,579
124,101,23,4,25,1,0,0.000902527075812274,1108
2688,1510,1178,6,25,4,0,0.000632511068943707,1581
308,96,212,4,4,3,0,0,1199
132,48,84,3,9,0,0,0,204
212,76,136,4,4,2,0,0.00115473441108545,866
337,167,170,6,3,3,0,0,961
499,273,226,5,4,1,0,0,397
4,1,3,1,91,1,0,0,209
4,2,2,2,129,2,0,0,0
18,12,6,4,29,2,0,0,142
77,42,35,5,29,3,0,0.000840689365279529,2379
14,13,1,1,178,0,0,0,516
4,2,2,2,62,1,0,0,272
4,2,2,2,129,2,0,0,0
3,2,1,1,29,1,0,0,134
6,1,5,1,91,1,0,0,394
128,79,49,4,18,4,0,0.00167879127028539,1787
4,2,2,2,129,2,0,0,0
7,5,2,2,14,1,0,0.0024390243902439,410
372,194,178,8,14,2,0,0.000959692898272553,1042
9,5,4,2,73,1,0,0,107
338,229,109,11,10,8,0,0.0018348623853211,2180
276,259,17,5,45,5,0,0.00145772594752187,1372
4,2,2,2,129,2,0,0,0
13,9,4,2,17,1,0,0,79
88,67,21,2,17,1,0,0,224
125,54,71,5,17,3,0,0.00153491941673062,1303
26,13,13,2,178,2,0,0,253
8,4,4,3,129,2,0,0,0
163,123,40,6,29,4,0,0.00403225806451613,496
7,5,2,1,58,1,0,0,1288
257,155,102,5,57,5,0,0.00185013876040703,1081
0,0,0,1,58,1,0,0.00398406374501992,502
1859,1055,804,8,31,3,0,0.000791765637371338,1263
174,77,97,3,53,1,0,0,121
43,35,8,2,53,0,0,0,51
1393,785,608,21,5,13,0,0.00131302521008403,3808
43,24,19,2,58,2,0,0.00221729490022173,451
0,0,0,1,178,1,0,0,38
12,7,5,3,73,2,0,0.00892857142857143,112
60,50,10,3,38,2,0,0.00208768267223382,479
0,0,0,1,73,0,0,0,222
775,449,326,11,23,8,0,0.00111317254174397,2695
87,51,36,5,1,5,0,0.000796812749003984,1255
0,0,0,1,73,0,0,0,0
202,100,102,2,53,0,0,0,0
0,0,0,1,53,0,0,0,0
10,5,5,1,131,1,0,0.00320512820512821,624
117,67,50,8,18,8,0,0.00106723585912487,2811
16,12,4,3,129,2,0,0,0
0,0,0,2,129,1,0,0,0
9,3,6,2,29,2,0,0.0133333333333333,75
194,90,104,8,17,6,0,0.00401069518716578,748
4,2,2,2,129,2,0,0,0
5,1,4,1,131,1,0,0,188
46,36,10,2,104,1,0,0.00628930817610063,318
12,3,9,1,131,1,0,0,312
269,176,93,15,18,8,0,0.00206291903042806,1939
6,5,1,1,66,0,0,0,72
11,8,3,3,66,1,0,0,43
29,26,3,2,66,0,0,0,359
14,4,10,1,131,1,0,0,194
37,25,12,7,24,3,0,0.00636942675159236,157
14,8,6,4,10,1,0,0,1221
209,47,162,4,63,3,0,0,662
81,58,23,5,66,1,0,0.00099009900990099,2020
14,10,4,3,101,2,0,0.00453514739229025,441
81,15,66,1,101,0,0,0,972
4,1,3,1,17,0,0,0,661
221,91,130,5,17,4,0,0.00196850393700787,1524
8,4,4,3,129,2,0,0,0
16,2,14,1,17,0,0,0,72
4,2,2,1,29,1,0,0,37
10,3,7,2,29,2,0,0,576
5,2,3,2,17,1,0,0,529
3,2,1,1,29,1,0,0.00561797752808989,178
13,7,6,1,107,1,0,0.00284090909090909,352
11,6,5,1,107,1,0,0.0256410256410256,39
3,2,1,1,29,1,0,0.00462962962962963,432
197,115,82,7,5,5,0,0.000515862780500387,3877
6,3,3,1,113,1,0,0.000866551126516464,1154
8,4,4,3,129,2,0,0,0
4,2,2,2,129,2,0,0,0
422,191,231,8,15,6,0,0.00163934426229508,1220
117,66,51,3,15,3,0,0.00740740740740741,270
54,25,29,3,15,2,0,0,390
1727,1061,666,16,15,14,0,0.00129954515919428,3078
110,66,44,8,15,5,0,0.004149377593361,241
0,0,0,1,109,1,0,0,91
34,30,4,2,15,1,0,0.00515463917525773,194
155,119,36,5,18,3,0,0.0104712041884817,191
108,42,66,8,14,5,0,0,233
532,447,85,3,15,2,0,0.00170164492342598,1763
60,34,26,4,129,2,0,0,0
321,184,137,5,18,4,0,0,354
192,181,11,3,107,2,0,0,1102
4,2,2,1,107,0,0,0,301
426,308,118,9,8,7,0,0.000942803268384664,3182
4,2,2,1,91,1,0,0,375
27,24,3,1,179,1,0,0,226
35,25,10,3,91,2,0,0,1837
4,2,2,1,91,1,0,0,81
0,0,0,1,44,0,0,0,0
0,0,0,1,44,0,0,0,0
4,2,2,2,44,0,0,0,0
0,0,0,1,44,0,0,0,0
0,0,0,1,44,0,0,0,0
4,2,2,2,129,2,0,0,0
170,69,101,3,17,1,0,0,237
1142,621,521,3,44,2,0,0.00118906064209275,841
3,1,2,1,44,0,0,0,209
248,116,132,1,44,0,0,0,454
0,0,0,1,44,0,0,0,198
349,174,175,1,44,0,0,0.00416666666666667,480
5941,4535,1406,2,44,0,0,0.000219154065307911,4563
407,208,199,2,44,0,0,0,208
479,218,261,2,26,1,0,0.00328947368421053,304
2,1,1,1,44,0,0,0,78
879,447,432,1,44,0,0,0,1266
1,1,0,2,44,0,0,0,14
203,102,101,1,44,0,0,0,293
189,109,80,8,14,1,0,0.0017921146953405,558
19,14,5,4,17,2,0,0,69
1036,559,477,10,14,6,0,0.00105485232067511,1896
0,0,0,1,44,0,0,0,0
0,0,0,1,44,0,0,0,0
281,186,95,3,17,1,0,0.00497512437810945,201
359,253,106,1,44,0,0,0,432
0,0,0,1,44,0,0,0,0
193,91,102,2,44,1,0,0,162
1,1,0,2,44,0,0,0,247
2,2,0,2,44,0,0,0,8
0,0,0,1,44,0,0,0,0
80,40,40,1,44,0,0,0,74
58,26,32,1,44,0,0,0,33
526,261,265,1,44,0,0,0,617
978,488,490,2,17,0,0,0,1268
0,0,0,1,44,0,0,0,0
9,4,5,1,29,1,0,0,586
4,2,2,2,129,2,0,0,0
11,7,4,2,29,2,0,0,74
35,20,15,2,17,1,0,0.00295420974889217,677
4,2,2,2,129,2,0,0,0
27,16,11,2,17,1,0,0,596
4,2,2,2,129,2,0,0,0
3,2,1,1,29,1,0,0,98
39,23,16,2,17,1,0,0,675
4,2,2,2,129,2,0,0,0
8,4,4,2,29,2,0,0,318
5,1,4,1,91,1,0,0,961
11,8,3,1,58,1,0,0,496
4,3,1,1,58,1,0,0,365
73,57,16,5,31,1,0,0,529
28,16,12,2,29,2,0,0,1102
4,2,2,1,58,1,0,0,709
3,1,2,1,91,1,0,0,896
4,2,2,2,129,2,0,0,0
3,2,1,1,29,1,0,0,108
4,1,3,1,91,1,0,0,197
60,31,29,3,15,2,0,0.00143266475644699,698
4,2,2,2,129,2,0,0,0
4,2,2,2,129,2,0,0,0
3,2,1,1,29,1,0,0,70
47,23,24,2,17,1,0,0.0012987012987013,770
4,2,2,2,129,2,0,0,0
101,61,40,10,12,6,0,0,296
104,75,29,3,58,1,0,0.00107181136120043,933
95,37,58,3,73,2,0,0,210
363,156,207,10,12,4,0,0,653
7,4,3,2,73,1,0,0,28
1050,605,445,31,10,21,0,0.00173160173160173,2310
36,33,3,1,58,1,0,0.0065359477124183,153
6,3,3,1,58,1,0,0,120
145,90,55,5,12,1,0,0,358
54,42,12,4,12,1,0,0.00236406619385343,423
8,4,4,2,73,0,0,0,769
2511,1471,1040,9,12,5,0,0.00266429840142096,1126
16,10,6,4,58,2,0,0,382
7,3,4,1,107,1,0,0,735
10,7,3,2,29,2,0,0.00467289719626168,214
8,2,6,1,75,0,0,0.00190961171228517,1571
597,546,51,2,105,2,0,0.00118063754427391,847
93,38,55,5,29,4,0,0.00175953079178886,1705
7,2,5,2,107,2,0,0.00289855072463768,690
61,31,30,6,9,4,0,0.00314465408805031,636
90,73,17,6,129,2,0,0,0
58,34,24,9,18,3,0,0.0133779264214047,299
66,35,31,2,139,0,0,0.00289435600578871,691
4,2,2,1,177,0,0,0,95
274,192,82,13,10,6,0,0.0068762278978389,1018
650,426,224,23,18,11,0,0.00124494242141301,3213
19,11,8,3,18,0,0,0.00279329608938547,358
72,38,34,6,9,3,0,0.00442086648983201,1131
54,42,12,5,18,3,0,0.00588235294117647,340
4,2,2,1,177,0,0,0,67
4,2,2,2,129,2,0,0,0
46,40,6,4,29,4,0,0,390
23,10,13,1,107,1,0,0,936
3,1,2,1,170,1,0,0,232
2,1,1,1,170,1,0,0,232
27,13,14,1,107,1,0,0,508
48,22,26,1,107,1,0,0,543
3,1,2,1,26,1,0,0,270
0,0,0,1,178,1,0,0.004,250
4,1,3,1,132,1,0,0,249
169,77,92,7,29,7,0,0.000918836140888208,3265
17,11,6,2,107,2,0,0.00149925037481259,667
528,312,216,6,29,5,0,0.00300902708124373,997
4,2,2,2,129,2,0,0,0
4,2,2,1,91,1,0,0,255
1302,319,983,10,5,8,0,0.00166666666666667,1800
4,2,2,2,129,2,0,0,0
229,12,217,4,29,3,0,0,126
132,68,64,6,17,3,0,0.000812347684809098,1231
4,2,2,2,129,2,0,0,0
0,0,0,1,58,1,0,0,1415
0,0,0,1,58,1,0,0,25
0,0,0,1,58,1,0,0,30
1,1,0,2,57,1,0,0,2
0,0,0,1,58,1,0,0,57
8,4,4,3,38,2,0,0,284
20,10,10,4,38,2,0,0,167
0,0,0,1,58,1,0,0,64
140,36,104,4,17,2,0,0.00147275405007364,1358
30,14,16,2,17,1,0,0,756
93,36,57,2,17,1,0,0,262
0,0,0,1,58,1,0,0,65
0,0,0,1,58,1,0,0.00227790432801822,439
0,0,0,1,58,1,0,0,62
0,0,0,1,58,1,0,0,63
7,2,5,2,17,1,0,0,129
0,0,0,1,58,1,0,0,47
0,0,0,1,58,1,0,0,59
0,0,0,1,58,1,0,0,141
0,0,0,1,58,1,0,0,80
0,0,0,1,58,1,0,0,74
0,0,0,1,58,1,0,0,43
8,3,5,2,17,1,0,0,272
0,0,0,1,58,1,0,0,180
27,6,21,2,17,1,0,0,130
0,0,0,1,58,1,0,0,62
6,3,3,2,18,2,0,0,16
4,2,2,1,29,1,0,0,22
587,463,124,9,1,2,0,0.00212765957446809,1410
4,3,1,1,147,1,0,0,217
4,3,1,1,147,1,0,0.00182149362477231,549
32,23,9,3,57,3,0,0.00360576923076923,832
8,4,4,3,129,3,0,0,0
4,3,1,1,57,1,0,0.0192307692307692,52
7,6,1,1,57,1,0,0.00595238095238095,168
49,32,17,1,131,1,0,0,887
4,3,1,1,131,1,0,0,92
580,382,198,1,58,1,0,0,2599
152,75,77,4,129,3,0,0,0
41,30,11,1,58,1,0,0.00184842883548983,541
38,16,22,3,18,3,0,0.000674308833445718,1483
4,2,2,2,129,2,0,0,0
6,3,3,2,129,2,0,0,0
25,12,13,2,62,2,0,0.000558347292015634,1791
4,2,2,2,129,2,0,0,0
4,2,2,2,129,2,0,0,0
429,280,149,6,15,6,0,0.000986679822397632,2027
8,4,4,3,129,2,0,0,0
6,3,3,2,129,2,0,0,0
19,9,10,1,62,1,0,0.000529100529100529,1890
6,3,3,2,129,2,0,0,0
23,13,10,1,18,1,0,0.00167224080267559,598
701,453,248,6,18,5,0,0,1659
4,2,2,2,129,2,0,0,0
108,94,14,5,129,4,0,0,0
455,307,148,6,15,5,0,0.000511116790186558,3913
537,316,221,10,5,7,0,0,503
515,200,315,6,33,3,0,0,521
347,239,108,7,11,6,0,0,323
48,20,28,5,8,3,0,0.0106382978723404,94
6,3,3,1,33,0,0,0,60
737,601,136,2,69,2,0,0.00127877237851662,782
120,59,61,8,18,5,0,0,183
110,24,86,3,33,2,0,0,88
11,8,3,1,147,1,0,0,51
7,4,3,3,147,2,0,0,1367
16,6,10,3,58,2,0,0.0121580547112462,329
56,38,18,2,36,1,0,0,650
551,267,284,8,36,6,0,0,3069
166,92,74,5,100,1,0,0,368
39,22,17,6,58,3,0,0.00074794315632012,1337
12,8,4,2,100,0,0,0,269
70,43,27,7,67,3,0,0,1283
118,45,73,19,14,10,0,0.00192492781520693,1039
91,68,23,4,106,2,0,0,179
0,0,0,1,107,0,0,0,57
11,7,4,1,95,1,0,0,87
6,3,3,1,119,0,0,0.00285714285714286,700
56,41,15,3,119,2,0,0,638
110,67,43,5,41,2,0,0.000598444045481747,1671
4,2,2,1,92,1,0,0,168
20,20,0,1,92,1,0,0,278
9,6,3,1,92,1,0,0,223
4,2,2,1,92,1,0,0,458
8,4,4,1,92,1,0,0,568
56,28,28,1,92,1,0,0,554
34,23,11,2,88,2,0,0,735
6,5,1,1,92,1,0,0,200
95,33,62,1,92,1,0,0,1077
4,2,2,1,92,1,0,0,714
82,79,3,1,92,1,0,0,496
185,110,75,1,92,1,0,0,1109
5,4,1,2,88,2,0,0,741
0,0,0,1,53,0,0,0,0
487,324,163,9,12,8,0,0.0015255530129672,1311
15,10,5,3,12,1,0,0.00826446280991736,242
0,0,0,1,43,0,0,0.00171821305841924,582
13,1,12,1,5,0,0,0,169
0,0,0,1,43,0,0,0,0
8,7,1,1,22,1,0,0,207
49,38,11,2,5,0,0,0,165
12,12,0,1,18,1,0,0.00297176820208024,673
7,4,3,1,43,0,0,0.024390243902439,41
0,0,0,1,40,0,0,0,0
0,0,0,1,40,0,0,0,0
0,0,0,1,40,0,0,0,0
0,0,0,1,40,0,0,0,0
0,0,0,1,40,0,0,0,0
88,49,39,1,147,1,0,0.0166666666666667,60
0,0,0,1,73,0,0,0,0
0,0,0,1,53,0,0,0,138
0,0,0,1,73,0,0,0,0
0,0,0,1,73,0,0,0,0
6,6,0,2,73,1,0,0,51
0,0,0,1,73,0,0,0,0
0,0,0,1,73,0,0,0,0
0,0,0,1,73,0,0,0,0
0,0,0,1,73,0,0,0,0
0,0,0,1,73,0,0,0,280
367,237,130,7,1,3,0,0.00200803212851406,498
699,442,257,3,31,0,0,0,1020
21,13,8,2,53,0,0,0,340
0,0,0,1,73,0,0,0,162
198,196,2,2,53,0,0,0,1023
0,0,0,1,73,0,0,0,760
0,0,0,1,73,0,0,0,594
0,0,0,1,73,0,0,0,51
21,21,0,3,31,0,0,0,959
15,15,0,2,53,0,0,0,223
4,4,0,2,53,0,0,0,116
21,21,0,2,53,0,0,0,231
0,0,0,1,73,0,0,0,227
0,0,0,1,73,0,0,0,251
1,1,0,2,53,0,0,0,459
0,0,0,1,73,0,0,0.00158730158730159,630
0,0,0,1,53,0,0,0,218
0,0,0,1,73,0,0,0,152
76,72,4,3,10,1,0,0,484
0,0,0,1,73,0,0,0,0
0,0,0,1,73,0,0,0,93
434,91,343,3,14,1,0,0,584
574,38,536,1,73,0,0,0,73
85,66,19,1,73,0,0,0,105
0,0,0,1,73,0,0,0,112
0,0,0,1,73,0,0,0,0
0,0,0,1,73,0,0,0,0
556,182,374,3,31,1,0,0.000807754442649435,1238
9,7,2,2,1,1,0,0.0050251256281407,199
670,52,618,1,73,0,0,0.0121951219512195,82
85,26,59,1,73,0,0,0.00520833333333333,192
0,0,0,1,73,0,0,0,0
0,0,0,1,73,0,0,0,0
0,0,0,1,73,0,0,0,0
0,0,0,1,73,0,0,0,0
0,0,0,1,73,0,0,0,0
0,0,0,1,73,0,0,0,67
0,0,0,1,73,0,0,0,0
0,0,0,1,73,0,0,0,0
1429,563,866,3,53,1,0,0,748
420,228,192,3,53,1,0,0,310
697,56,641,3,53,1,0,0,80
1081,595,486,3,53,1,0,0,629
1706,888,818,3,53,1,0,0,1083
0,0,0,1,73,0,0,0,11645
0,0,0,1,73,0,0,0,215
0,0,0,1,73,0,0,0,0
4,3,1,2,53,0,0,0,81
0,0,0,1,73,0,0,0,0
777,256,521,5,10,3,0,0,983
0,0,0,1,73,0,0,0,0
101,57,44,5,1,3,0,0,287
781,87,694,5,53,3,0,0,92
254,168,86,3,53,1,0,0,548
670,284,386,4,53,2,0,0,1528
4,3,1,2,53,0,0,0,81
0,0,0,1,145,1,0,0,298
0,0,0,2,11,1,0,0,0
393,230,163,5,2,2,0,0,1381
48,28,20,3,53,1,0,0,333
729,58,671,3,53,1,0,0,89
221,125,96,4,31,1,0,0,738
332,184,148,3,53,1,0,0,1483
0,0,0,1,14,0,0,0,50
0,0,0,1,11,0,0,0,0
39,22,17,3,12,2,0,0,36
706,43,663,2,14,0,0,0,74
53,4,49,1,14,0,0,0,45
12,8,4,2,14,0,0,0,309
0,0,0,1,73,0,0,0,44
0,0,0,1,73,0,0,0,42
0,0,0,1,73,0,0,0,0
687,26,661,1,73,0,0,0,61
0,0,0,1,73,0,0,0,0
0,0,0,1,73,0,0,0,0
543,377,166,6,14,1,0,0,1358
34,17,17,1,73,0,0,0,435
11,4,7,2,53,0,0,0.0113636363636364,88
322,256,66,2,53,0,0,0,311
87,48,39,5,10,3,0,0,422
84,49,35,3,53,1,0,0,368
17,8,9,4,14,1,0,0.0169491525423729,59
572,425,147,6,18,4,0,0,744
156,95,61,4,106,2,0,0.00760456273764259,263
22,18,4,1,14,0,0,0.00318471337579618,314
6,5,1,1,176,1,0,0.00636942675159236,157
18,14,4,2,107,2,0,0,108
11,7,4,1,107,1,0,0,87
10,6,4,1,89,0,0,0.0120967741935484,248
15,12,3,2,62,1,0,0.0202020202020202,99
54,40,14,2,1,2,0,0,59
259,177,82,12,5,8,0,0.00384615384615385,1040
7,4,3,1,176,1,0,0,37
7,4,3,1,33,0,0,0,448
8,7,1,1,14,0,0,0,69
5,3,2,1,10,1,0,0,160
65,54,11,5,15,3,0,0.000514933058702369,1942
7,7,0,1,107,1,0,0,671
65,41,24,4,106,2,0,0,135
10,5,5,1,29,1,0,0.00395256916996047,253
7,0,7,1,107,1,0,0,32
0,0,0,1,5,0,0,0,0
0,0,0,1,5,0,0,0,0
0,0,0,1,5,0,0,0,0
0,0,0,1,5,0,0,0,0
0,0,0,1,5,0,0,0,0
0,0,0,1,5,0,0,0,0
0,0,0,1,5,0,0,0,0
0,0,0,1,5,0,0,0,0
42,25,17,8,5,5,0,0,0
262,259,3,2,5,1,0,0,0
4,1,3,2,5,1,0,0,0
0,0,0,1,5,0,0,0,0
0,0,0,1,5,0,0,0,0
0,0,0,1,5,0,0,0,0
0,0,0,1,5,0,0,0,0
0,0,0,1,5,0,0,0,0
0,0,0,1,5,0,0,0,0
0,0,0,1,5,0,0,0,0
0,0,0,1,5,0,0,0.00961538461538462,104
0,0,0,1,5,0,0,0.0121580547112462,329
0,0,0,1,5,0,0,0,124
0,0,0,1,5,0,0,0,56
0,0,0,1,5,0,0,0,112
0,0,0,1,5,0,0,0.00609756097560976,492
0,0,0,1,5,0,0,0.00634920634920635,315
0,0,0,1,5,0,0,0.00418410041841004,239
3,2,1,1,88,1,0,0,538
618,603,15,3,29,3,0,0.00335195530726257,895
243,243,0,1,107,1,0,0,293
12,8,4,3,87,3,0,0.0065359477124183,153
147,78,69,6,5,3,0,0.0022075055187638,906
28,6,22,4,14,3,0,0.00389105058365759,257
23,14,9,4,15,3,0,0,341
5,3,2,1,53,0,0,0,656
120,97,23,3,1,1,0,0,561
7,4,3,2,62,1,0,0.0212765957446809,47
208,64,144,3,47,1,0,0,71
79,41,38,8,47,6,0,0,113
114,61,53,6,47,4,0,0,107
4,3,1,1,101,1,0,0.00510204081632653,196
4,3,1,1,86,0,0,0.00588235294117647,170
4,3,1,1,101,1,0,0.00253807106598985,394
4,3,1,1,101,1,0,0.00478468899521531,209
4,3,1,1,101,1,0,0.00202020202020202,495
130,64,66,3,101,2,0,0.00112994350282486,885
1,1,0,1,107,1,0,0.00164473684210526,608
8,7,1,1,101,1,0,0.00373134328358209,268
8,7,1,1,101,1,0,0.00333333333333333,300
58,57,1,2,107,2,0,0,279
19,16,3,2,107,2,0,0,980
4,1,3,1,86,0,0,0,184
1,1,0,1,178,1,0,0,431
13,11,2,1,54,0,0,0,633
290,137,153,3,8,3,0,0.00261780104712042,382
35,8,27,3,15,3,0,0,55
28,27,1,1,15,1,0,0,34
219,108,111,4,15,4,0,0,477
7,1,6,2,107,1,0,0,301
332,215,117,8,23,5,0,0,2007
25,19,6,4,23,2,0,0,236
12,2,10,1,15,1,0,0,12
18,4,14,1,103,1,0,0,385
26,20,6,1,103,1,0,0,653
25,1,24,1,18,1,0,0.00134589502018843,743
89,78,11,4,18,2,0,0.000664451827242525,1505
458,367,91,8,0,2,0,0.00161030595813205,621
64,49,15,2,48,0,0,0.000571755288736421,1749
16,8,8,2,18,2,0,0,515
2,1,1,1,86,1,0,0,803
118,63,55,18,15,6,0,0.0967741935483871,31
310,146,164,2,92,1,0,0,680
151,89,62,4,10,2,0,0.0045045045045045,444
17,0,17,1,176,0,0,0.00346020761245675,289
25,22,3,3,12,0,0,0.00900900900900901,222
82,72,10,4,12,3,0,0.000419375131054728,4769
10,7,3,1,18,1,0,0.000558347292015634,1791
468,380,88,13,12,7,0,0.00226551880380607,2207
1061,806,255,6,65,1,0,0.00146198830409357,1368
4,2,2,1,92,0,0,0,74
154,100,54,3,5,3,0,0.0150753768844221,398
68,59,9,3,15,3,0,0,215
13,9,4,3,70,2,0,0,449
12,9,3,2,41,0,0,0,439
402,338,64,4,8,3,0,0.00298953662182362,669
13,9,4,3,1,3,0,0,49
62,33,29,4,12,2,0,0.00182481751824818,548
4,2,2,1,70,0,0,0.00101729399796541,983
15,10,5,1,178,1,0,0,145
263,203,60,11,12,6,0,0.000600781015319916,3329
0,0,0,2,129,1,0,0,0
4,3,1,1,67,1,0,0,980
144,110,34,2,40,1,0,0.000362450163102573,2759
0,0,0,2,129,1,0,0,0
10,8,2,1,107,1,0,0,179
16,10,6,2,49,1,0,0,309
